FCECB->EADEABBAEC
FCEBB->ACBABACDED
EEDDA->FBFAFCCBFD
EFAAE->FAEDDCBCAD
EDDBC->DFCBEBCDFD
EFFAD->BFEDABFECA
ABCFF->CDCDAFABAC
ECFAA->BFDEBCBCDC
BDBAF->ECEFEDBCEA
EECFB->BADCFDEDCF
EDEFF->ABCBDFEDEA
CFCDB->EFEDBFEFCD
CDAAD->FECBEDFEAE
EFDEF->CBEDFADCEA
FDDCC->CBCBFCBAEB
AABCF->BEFEECBABE
DACCF->BAFEDFBACB
FBCAC->CACDFDFEDA
CDDEB->FDCBEFDCAE
AEEFF->DCFABAEDBE
ABEBC->BEAFABAFFE
DCDEF->EABAFCDCCB
EEEAE->FCFAFBBCBF
DBDAC->EBCDAEBCFD
DACCD->AEBCFDBAEF
BEEFB->CEDCADABAE
EDEDA->FCEFABCBED
BFCFE->DAEDBFABFA
EEBEC->DFDCDEDCEB
BACFC->FEBCFDEDFD
CCEEF->FDBAFCFABC
EBCEA->BFCDFDDCBE
ABBFB->CFCDFEABEC
BDEDD->ACEFABCBFC
FBEDC->BECDADEFBD
FEDDA->BEFACECBCD
BBECD->CFAFABBACE
EAACC->BABCFBDEDF
FFDCF->BCABFCBADC
DCCEF->CEBADAFABC
FEEDC->ABDCDFCBDE
EABCE->BFBCECBABF
DBAAB->AFCDFBFEEC
CBACE->BDAFBCBAFB
ADAAF->CFCBFDFECB
BCFBB->ECBABECDFE
DEABC->AEFACFCDBF
BCFAC->FEDEBCBCAF
ACDDF->DBDEAEEFCA
EEEEA->FBFADFDCBD
ABFAF->DBAFCBFECA
BCFCD->CFBABCDECA
ADFCE->BECBACBABA
CBCFD->AFCDFDEDFA
EBCAA->DFAFFDFEDC
ACEFF->CFDEDBEDAB
DFDFE->AEABAFABAD
BCDAF->EDBACEFEAB
DDFDD->EACBEAEFEA
BABAD->CFFEECFEAE
CCEEE->DFBADFDCFC
EDFAE->CDCBEABCDF
CCBDF->BDBACDEFBC
ACBCB->FDBAEDBAEC
CCAFD->EBDEFBABEB
FABDA->ECFECFCBCD
CACFD->FEBCAFABEB
DACBB->FCFEAFCDCF
AFCAB->FDEDEBFEED
DCDBE->CADEFCAFDB
BDCFA->EDEFEBEDDC
DDADA->AFCBEDCBCD
DADFD->FAFECAEDAF
FCDEB->ADBAAEFAED
CBFEE->DACDADFAFB
BDCAA->CDEFFDFEDC
EBFFA->CBAFABEDDC
BCDEE->ACDECAFABF
FCBDA->BEDEEDEFBE
DFBAB->AEABECFECD
FBEFD->EACDFAEDFC
EDFCD->BFEFCADEAE
EEBBE->CDFAEDCDBF
EEFFF->ABDCEAABAC
DFCDD->AEABEFCBFC
CBEAB->DACDFAFEEC
ADFCB->CDCBDCBACD
DEDEF->AFDCAEFABE
FFCFF->CAEDFDEDCB
EAECB->BFBCBABAEC
ABDDB->DCCDBAEFED
FFCAC->ABEDBFBCEB
DCECB->CEBAFBDEDA
FFFEA->BEABDCDCBE
EBBDC->FACDFEEFDE
AEEAC->BDFADFFEDF
FAEDB->ACBCBFEFED
CEDAD->EBDCFCFECA
BFEAE->ECEDABFEBF
CBFDD->BFCDABCBCE
ACFAD->DCDEADFEFA
CFCBB->FDEDFDAFED
BAEFC->DEBCADABEB
EBCFF->ABAFFEABCB
ADFFA->DBEFCAEDBC
AEBAF->CFDCAEFECB
EBFFE->BFCDCBEDBF
CEBAC->DEFACDBCBF
CBCCE->FDAFDEDEDB
DEEDB->EBFAFBEFEC
AFBBA->CDABFECDBC
AEDED->BEDCFADCAE
FDDCC->CBCBFCBAEB
BFBED->ACABDEDCFC
DECCA->FCDCEBDEFB
AAABF->BEFEBEAFAB
EDDCA->FCEFEABABE
CCFEF->DADEABDCCB
AEEDD->DCFABACBFC
ADAAA->DBEFCDBCDC
FEBDB->EAFACDEFCF
BFDFA->CDABCEABCD
BBDBB->CEAFCEAFCF
CFFBC->EFEDEACDEF
BADED->CEBCEBFAAE
AFBFF->CFABFEABAD
FDFDF->ADEFCAEFCA
BBBBC->DECDEDCDAF
FDEAC->CAEFBFBCFD
BFECC->FEABFADEAF
AFBBC->DBEDCFAFFD
DEEDE->FADCADEFCB
DDDAB->CECBEBFEEC
BFFCB->CDABDCBACD
ADDAD->DBEFEBFEFA
BDBDD->CFCBCDEFEA
BDFCB->DECBCBBAEC
FFFAC->BEABDCFEDA
BFDBA->ECEDFACDFB
EFEAD->ADABBABCEB
AEEED->BCDCDFDCEF
FBDED->EACDFADCAE
EFEAA->CBEDABFECF
BBCAB->CEAFEBFEED
FFBFA->CAEDCFEDBC
BCBCC->FEDECDDEAF
FBDED->EACDFADCAE
AEDFF->BCDCFCEDEA
AAFAE->DBFEBCBCAD
EBFBD->BACDBECDCA
CFEEC->FDEDABDCFD
CBEAD->FECDBFBCFA
CCACE->FEBADBDEBF
DAEAD->FAFEADBCFC
DEAEA->EBFACDFAED
FFDFF->ADABEBABAC
CFCBE->FEABFDAFBF
DDEAF->AFCBDFFEAB
EBCAB->ADCDBFBCDA
EBFBA->BFCDCBAFBE
ADBFB->DCEFDAEDFE
ACBFE->BEBACDABBA
BECBB->CFDCDECDFE
BDFDD->CECBEAEFEA
AFBDC->FBABDECBFD
CDBAA->DAEFCFFEBE
ECBCE->ABBAECBABF
EFDFE->BFEDAFABAD
CCABE->BDBABCAFDB
AABBD->DBFECDCDCA
BFADE->DAEDDCEFCB
DCDFF->CEBAAEABAD
DACBD->EBFEDFAFCE
BDBBE->ACEFCFAFAB
AFDDF->DCABFCCBDC
DCBBC->AFBAECAFDE
EFFBA->CBEDCBAFBE
FEDCF->ACFAFCBADC
AAACD->FBFEBEBAAE
FFDCC->ADABEBDEDF
DDBCD->EFCBDADECA
EECEC->ADFABDFADA
CDFAA->EBCBDCFEDC
DBCAE->BACDFDFEAB
CFADD->EFEDDCEFAF
AFAFB->DBEDBCEDFE
DCDDA->EBDEFACBED
FEECD->EAFAFBDEAF
BADAE->ACFEFAFEAD
EDFCB->DFCBACBAEC
AFBEC->DCABFEFADA
BEBAD->EDFAECFEAE
ACDED->DCDEAFDCAE
FCFCB->ACBADCBACD
AAFAB->DCBCEABCAE
DFCEB->AFABDAFACD
EFFBA->CBEDCBAFBE
DFEED->EBABBFDCFA
ABFDF->DCCDBECBDC
EEDFE->FCFAAEABFA
CFCFF->FDEDFDEDCB
ABDAE->DCCDBAFEFA
DFFAE->CAEDABFEAD
DFCBB->AEABEFCDED
BBBAF->CDCDFEBCAB
CEBEA->DEFACDFAFD
DEBBF->CEDCAEAFCB
ADDEF->CDCBCEDCCB
CDFFB->DAEFBCABFE
DFCAF->EAEDFEBCEA
FCBFC->BEDEEDABFD
AFBFD->DCABFEABAF
AEBFE->CFDCAEEDBA
FFCAA->CAEDFDFEDC
EBFAC->BACDBEBCBF
CDCDB->FDCBFECBEC
EDFAB->BFEFCAFECF
FBCBF->ABAFFDAFBC
BCCBD->CEBAFDAFEB
FDCBB->DCEFDECDFE
AFEEB->CFABDFDCDE
FAFCF->ACBCBEDEBE
FFEED->ADABBFDCFA
AAEDA->CDBCADEFDB
EFECF->ADABBABADC
EDACF->BACBEDBACA
BCDCF->CFBAAEDEBC
CFEEA->BDABBFDCBE
FBFFF->ADAFABEDEA
CBDDF->DACDFACBCB
DDDDF->EACBAEEFCA
EFAEF->ADABFDFABE
FCDFD->ABDECAEDAF
AFBDA->BCEDFEEFCD
EEBEC->DFDCDEDCEB
CEFAE->AFDCABFEAD
DAFEB->FCFEBEFAEC
CDAAB->DAEFBCFEED
AEEFA->CDFABAEDFB
AEFCC->FBFABCDEAF
FAFBC->CBFECACDFD
BCDAD->CFBAAEBCFA
CBDBE->AFCDAECDAB
CDEBF->DECBBACDBE
FDDFD->ADEFEBABEB
BABDB->CDBCAECBED
CEAEB->DEFACDFAEC
AEDBF->DBDCFACDBE
FFBBC->CAEDCFAFFD
BCFCF->EDBADCBABC
FCDDC->CBBACECBDE
ADBAE->CFCBDABCAD
BBAEF->EDCDFBFABC
BDBFC->DECBECEDFD
AACAD->BCFEAFBCFA
BFDFB->FAEDAFABED
FDBEF->ABCBDADCCB
FBBBF->ADAFCFAFAB
EBBFA->DFAFCFEDBC
FEAEB->DCDCBEDCEC
DDCCD->BCEFDADEFA
EFDAB->FAEDFCFEED
AFDEE->BEABEBFAFB
CFEDF->BDABBFEFCA
AADBF->CDBCAECDCB
FDEED->CBCBDFDCEF
CABAC->FDFECDBCBF
BECAC->EDFAEBFEAF
FBAEE->ABAFBCDCDF
CCEAE->FEBABABCBF
BCCAA->EDBAEBFEFB
DBECB->FCAFDBDECF
BDBAD->ACEFCFFEFA
CCFBF->BDBABCCDBE
AEACF->BCDCEDBACA
CFFFA->BDABACABDC
ADAEA->BCCBFDFACF
ADFCF->BCCBDCBABC
EBCDD->ABAFFECBFC
CDCBF->FDCBFECDBE
BBFBC->FECDCBAFEB
DFBCB->CEABDEBAEC
FCABD->CBBADBAFAE
FDAFC->CBCBEDEDFD
EAEDF->BABCBFEFCA
FEFBB->EAFABCCDED
BABCE->ECFECDDEDB
BBEFB->CDCDADABAE
ACDED->DCDEAFDCAE
EBCAE->FACDBFBCFA
BECAF->ECDCEFBCEA
BBDEC->EDCDBADCEF
FBABD->EACDDBAFAE
CEEAA->FEFADFFEBE
CABAB->EBFEEDBCFE
ACDFE->DCDEAFABAD
ECEDE->BFDEBFEFBF
CFBAD->AFABDEBCAE
EFBDA->CBEDCFCBCD
BFCCC->ECEDFDBAFE
CDAEC->EFCBEDDCEF
EADBE->CDFEFCAFDB
CABBF->DEBCAEAFCB
ECAEF->CBDEDCFADC
CBBBD->EBCDEDCDBA
EDEEA->BFEFBFDCBE
BBDAD->FECDAEBCFA
AFBDC->FBABDECBFD
ADBBD->DCEFDACDCA
ADDAA->EFEFAEBCBE
EABEA->BFBCECDCBE
BDCCE->ACEFFDBAFC
BDDFF->EDEFCEABAC
DDEAE->BAEFBFBCBA
EEFAE->FADCCBFEBF
BACAE->EDBCAFBCBA
BEEEA->DADCDFDCBD
DADCD->EBFEFABACE
DACBE->BAFEDFAFBA
DBFCD->EFCDEADEFA
AEBCE->BCDCAEBABF
EADCB->ADBCFCBAEC
CDCBC->ABEFDACDEF
BFDDB->CEABAEEFED
CDBFE->FDCBEDABDF
DDFFE->FACBCBEDBF
DCCEE->AFBAEBDCDF
FCFBC->ADBABCCDAF
FDBEB->EAEFCFDCDE
BDEBF->CDEFABAFBE
AACBB->CFBCBFCDEC
EDEBB->DFCBBFCDCF
AADCB->CFBCFCBAEC
CFDBB->DAABEBCDCF
BFBEF->ECEDCFDCCA
DEBBA->FCDCAEAFDC
FECCC->ADFADADEDF
CBAAF->DACDDBFEBC
EFFDC->FAEDEAEFFD
DFDEC->FCEDFCDCEB
EAEFB->BABCBFEDEC
EBEDA->BACDBFEFCD
ACACF->CDBADBDEBC
ECDDB->FADECAEFCD
AAEEB->CDBCADFADA
BFCCA->DEABFDBACD
EEFBE->FCFABCCDBF
EBAEF->BACDFBFABC
DBCFB->AECDFDEDCF
EDBFE->BFEFEDABDF
EFBEA->FCABDEDCED
BACCA->EDBCAFDEDC
BBFFF->CFAFABEDEA
EDEFB->BFEFBFEDEC
CCDEF->EBDECAFABE
AFDEA->EFABAEFACF
ECDEC->FADECAFADE
BDEAE->CDEFABFEBF
ACEAA->BDBADFFEBE
ECCFE->FADEAFABBF
ADEEC->EDCBBFDCEF
BBBBB->FACDECAFED
EDCFE->FCEFFDEDAB
ECDFB->BFDEAEABEC
EEFAC->BFDCABFEAF
BBBDD->EDCDEDEFCE
FBBAC->BECDFEBCFD
FDEBA->CBCBDFAFBC
ABEED->CFCDADFAAF
DEABA->CEDCEDAFCD
ACAEE->BEBABCDCDF
BCDEB->CFBAAEFAED
ACDAC->DBDEAEBCFD
CDDBD->EBCBCEAFEA
EFFEA->FBABEAFACD
CCFAC->DEDEBEBCBF
DFCAB->EBABDEBCAE
BEBBC->AEDCECAFDE
EDFDD->ADEFDCEFEB
ACFDC->BDBACBCBFD
FABFC->ADFEECEDFD
DBFDB->FCAFBECBDA
CDBAD->EFCBECFEAE
EFFFC->BFEDABEDBF
EBBCA->FCAFCFBABC
BEACC->DADCEDBAFE
ACBAE->DBDECDBCDF
CAFCC->DEBCCBBAEB
FEEDE->BCFABACBDF
ECFCE->FADEBEDEDB
CFDEA->FEABFCDCED
FFAFB->CAEDBCEDFE
BDBCF->ACEFCFBABC
FFBAD->ABEDFEBCFA
DAFBB->EFBCCBAFEC
CDBEA->FECBECDCBE
EEBEF->DBFAEDFADC
BDFBF->EDEFCBAFAD
FABCD->BEBCAEBAEB
FAFBD->EABCCBAFCE
BFFEC->AEEDABDCEB
ABDDB->DCCDBAEFED
DCEFE->FABABAEDBF
CBFCC->DACDADBADA
FCAAF->CADEDCBCEA
FAFED->ADFEABDCFC
AFBFB->FDEDECEDCF
BDBCD->FEEFEDBACE
AFEBC->DCABDFAFFD
DDBCB->AEEFEDBAEC
DCFCE->BADEBCDEDB
CBEBD->AFCDABAFBA
CCBDD->AFDECDEFEA
ABDCA->EFCDFCBADB
AFABC->BDABDCCDAF
AAEDE->BCFEADEFCB
FAFDB->CAFECBCBEC
ABBFE->BCAFACABBF
ADADB->CDCBFDEFED
CBBAA->FECDEDBCDC
BEAEC->EDFAEDDCEF
CCECD->FDBAFCDEAE
EBFFB->BACDBEABAE
CBCCD->EBCDAFDEAE
EDDEF->ABCBFCDCCB
FCEFE->BCDEDBEDBA
FFAAE->ABEDDCBCAD
DEEAF->BADCBABCBE
BCCCC->EDBAEBDEAF
ABBFC->DBAFCDABEB
AEEBA->BCDCDFAFBC
DCBAF->EBDEECFEBC
FCDDE->BEDECAEFAD
CAEFD->EBFEADABCE
ABCFA->BDAFEBEDDC
EBACB->FCAFBCBACD
BEEAC->DADCDFFEDF
BFBFA->ECEDCFEDBC
BBAEF->EDCDFBFABC
BBECB->CEAFBABAEC
EDFEC->BACBCBDCFD
ECFAD->BABADCFEAE
FAAAD->CAFEBCFECA
AAFBE->CFBCCBAFBA
BAAFF->EDBCDCABCB
ABAFB->CDCDFBABDE
CFCCA->BDABDEDEFB
EBFFC->DFAFABEDBF
FDBEA->CBCBECDCBE
ACCBD->CFDEAFCDAE
BACDF->CFFEDFCBEA
DEEAB->CEDCDFFEEC
EDDDC->FACBCECBDE
ECADC->BFDEDCEFBD
BFEFA->EDABDFEDDC
DDAFD->FACBEDEDFA
CDEDA->DAEFABCBED
DDCDD->EFCBEBCBCE
CEAFF->EBDCEDEDCB
AECFD->CFDCEBEDFC
DEAEA->EBFACDFAED
CCBEA->BDBACDFAFD
CDEFE->FECBDFEDAD
DDDEB->AEEFEBFACD
CCAAB->DEDEFBFEEC
CEBEF->DAFACDFAEC
EADAC->FAFEFAFEAF
CECAE->DFDCDABCBA
BDBAD->ACEFCFFEFA
BEDFE->CFDCEFABBF
FAFAB->CBFECAFECF
CFEBA->DAABBFCDBC
CDEBC->DFCBADCDBF
AADBA->BDBCEBCDBC
DBDBA->CEAFEAAFBE
FAECD->ABFEADDECA
BEBED->CEDCFEFAAE
DAFBB->EFBCCBAFEC
FAEBB->ADFEFACDFE
BBFEB->DECDBEFAEC
DFBBE->BAEDCFAFAB
DFFAA->AFABEABCED
DFABA->AFABDCCDFB
CAAEE->FEBCDCFABA
BEAFE->ACFACDABDF
AFABC->BDABDCCDAF
CAEFE->FDFEABEDBF
BBDFA->ECAFEBABCD
AADFD->FBFEFAEDAE
FEACC->BEFAEDBAFE
ADFCB->CDCBDCBACD
BDAFE->DACBFDEDBA
BCCFA->DEBAEBEDDC
BCFCD->CFBABCDECA
FFFFD->ADABACABAE
FFAFE->CBEDFBABBF
BAAAE->CFFEBEFEFA
FCFCE->ABDEBEDEDB
BAEBD->EDBCADCDCA
FFEEF->DEEDBADCEA
DEFCA->EFDCCBBADB
ECDBF->CBDEAECDCB
DFBED->FAEDEDFACE
CADDE->DABCFACBDF
FABCA->DCFECDDEFB
BBEBE->EDCDBFCDAB
DFCAD->BCEDEBFECA
CFCDD->FDEDFDCBEF
CDFFC->DECBDCEDFD
DEBCE->BADCECBABF
EBFBE->ABAFBECDAD
CDFED->EFCBCBDCAE
EEEAC->ADFACBFEDA
FDDFB->ACEFCEABDE
FFEDC->ADABBFEFDE
EDDCA->FCEFEABABE
DECFA->EFDCEBEDDC
EDDCD->ABCBFCBACE
EEDFF->CBDCFAEDBE
CACBA->BDFEDFAFBE
CCCAF->DEDEAFBCAB
FCFFA->ECDEBCABED
BFFFE->CDABDCEDAB
CBAFF->DECDDCABCB
AECCB->DBDCEFBAEC
AFDFF->BEABEBABAC
CDDAB->EFCBFCFEED
FBDFC->ABAFEAEDFE
DFEDE->AFABADEFCB
BDDFA->DECBFCEDDC
DCABD->BCBABEAFEA
AADDC->BDBCEBEFFD
FEBCA->BCFAECBADC
ECEBF->BABABACDBE
BCFED->CEBACBDCAE
DAFCE->FAFEBEDEDB
BFDBC->FEABAFCDAF
BCEBE->CDDEDBCDAB
FBDED->EACDFADCAE
EFBFA->BFEDECEDBC
FCFCA->BCDEBEDEFB
FCABD->CBBADBAFAE
CACEF->FDFEDAFABC
ABEFE->CFCDADABBA
DCFDA->AFBADCEFCD
DCEFA->AEDEBFEDBE
ACBCF->CFDEEDBADC
EFADD->ABEDFBEFEA
AEFCE->DBDCABDEDB
EFDDE->FAEDFCCBBA
FCFBD->ABDEBECDCA
CFBEA->DAABDEDCED
FEEED->ABDCDFDCEF
DBBBD->EAAFECAFEB
AABFA->BDBCEDABED
FBBDD->CBAFECEFEB
DFADC->AFABDCEFBD
DAAEA->FCFEFBFACD
BFAFA->DAEDDCABED
FABAA->BCBCFEBCBE
AAEFC->FBFEFAEDBF
AFCAE->FBABDEBCDF
CAAFB->EBFEFBABDE
FCBEA->BCDEEDFAED
EAEEB->DFFEFADCAE
EBDBE->FACDCACDBA
EAFDF->ABFECAEFCA
ACEFE->FBDEABEDBF
FBBCD->EACDCEBAFC
ECAFB->BABADBEDCF
AAECC->BEFEFADEAF
FAECF->BCBCADDEBE
EEFDB->FADCCBCBEC
DDACD->EBEFBCBAAE
BCCED->FEDEDAFAAE
DCBAC->FABAECFEDA
FDDBE->CAEFEBCDAB
FFDDC->CAEDFACBFD
DEEFA->CEDCDFEDDC
CCAAE->DFBABEFEFA
BADFA->CFFEFAEDFB
BDAEA->CDEFBCDCED
ABBEA->BDAFECDCBE
BDFBD->CFCBACAFCE
FBCDD->EACDEFCBFC
DBFEE->CACDABDCDF
BDCDB->ECEFDECBDA
BCDDE->DADECAEFAD
DABAB->FCFEEDBCFE
EFEFA->BAEDBFEDBE
AEFDE->CFDCCBCBDF
AFFFE->BCEDEAABBF
BAECD->FEBCBABACE
FACAE->CBFEFEBCAD
ECDBF->CBDEAECDCB
BDEFA->DACBBAEDFB
CDECA->DECBBABADB
BBBAF->CDCDFEBCAB
BBDED->ACAFEADCEB
AEDDE->DCFACECBBF
BAAAA->EDBCDCBCDC
DDEBB->CECBBFCDCF
ABBBC->FBCDFECDFD
CABBF->DEBCAEAFCB
BFCEE->ECEDFDDCBA
AEADC->FBFACDCBEB
EAAAF->CBFEDCBCEA
DBEEA->EFCDADFAFD
DEBCD->EBFACDDECA
ADEDB->EDCBBFEFED
DDAAF->EACBDCBCEA
ADBAA->BECBCDBCED
FABDD->EABCAECBEF
EECDD->FCFADAEFEA
AACCE->BEFEDFBADF
DBACD->BCAFDCDEAF
BADEF->CFFEFADCEA
FAEDF->DEFEBACBCB
FCBBE->BEDEEDCDBF
AECEA->EFFADEFACD
DBFAE->FCAFBEBCDF
EADCC->BFBCFABAEB
BEBFB->CDFADAEDFE
CBAFA->FECDFBABCD
ADDCF->DBEFEBDEAB
DDFBB->FCCBDCAFED
DBFAC->AFCDBEBCBF
DFDFE->AEABAFABAD
AEAEE->CFDCEDDCBA
ECEFA->BFDEBFEDBE
CFDAD->EFEDFCFECA
FCECB->EADEABBAEC
CBFCC->DACDADBADA
DEADC->FADCDCEFBD
DCFFE->FCBADCEDAB
CBABA->DACDDBAFDC
CEBDC->DFDCEDEFEB
BAEEC->DABCADFABD
DDDBC->FACBFCAFFE
FCEBC->CADEBFCDFD
ACBCD->DCDEDADECA
DABCE->AEBCECBABF
FFDCB->CAEDFABAEC
CFBBC->FDEDCFAFFD
CEDBB->DEFAAECDCF
EBEAE->ABAFDBFEBA
FCEFC->ABDEDBEDEB
EFFAE->FCABACBCBF
FADAF->ACBCEBFEAB
FDECD->BECBBABACE
BAFAE->ECFEBCBCAD
BEAEF->ECDCBEDCAB
BFDFD->CEABAEABAF
FAAAE->ADFEBEFEFA
BBDCB->DECDBADECD
EDCDA->FBEFEBCBFD
ADDAC->BDCBFCFEAF
CCEFC->DEDEDBEDEB
AEFEA->DBDCABDCED
CBBDE->BDAFCFCBBF
AEBFA->BEDCECEDBC
AFABB->CDABEDAFED
DEAFD->BCFACFABFC
EAECC->FCFEFADEAF
EFBBC->BFEDECAFDE
CBEAB->DACDFAFEEC
CDBDC->FDCBEDEFEB
DACDE->AEBCFDCBFC
AEFCD->CFDCCBBACE
DCDDF->AEDEAEEFCA
AAEFE->DBFEABEDBF
CFBFA->FDEDCFEDBC
FDEEA->CAEFBFDCBE
FCFDF->ABDEBECBDC
FAAEF->BCBCDCFADC
BDFEC->EDEFCBDCFD
FABDA->ECFECFCBCD
ACECB->CDBABABAEC
BBEEA->CDCDADFAFD
DEFDD->FADCEAEFEA
FECAA->ECFADEBCED
EBADD->FACDDCEFAF
AEDDE->DCFACECBBF
FABEA->CAFECFDCBD
DBDDF->EBCDAEEFCA
AABFF->CDBCFEABAD
BBCCD->CEAFEBDECA
BDEAA->DECBDFFEBE
EAECB->BFBCBABAEC
EEFCC->DFDCCADEDA
ADBCB->DBEFEDBAEC
ACDAC->DBDEAEBCFD
BFDEA->EDABFCDCED
AFDAD->FBABEBFEFA
DBAFE->CACDBEABBF
CFFCC->ABEDABDEAF
EEEFB->ADFACBEDCF
CAFEC->FDFEBCFAEB
BDAEC->DECBEDDCEF
FCFDB->EADEABCBDA
ACDCB->DCDEAFBAEC
BECDD->CFDCDECBCE
AEACF->BCDCEDBACA
FADED->BEBCFCDCFC
DDDFC->AEEFEBABDE
BBAEF->EDCDFBFABC
CCCEB->FDBAFEFACF
ADEAC->DBEFBFBCFD
CDBCF->BDCBDADEBE
FFBFB->ADABDEABFE
FDDBF->ADEFEBCDCB
FFDDE->ABEDFCCBBA
CAAAF->DEBCEDFEBC
AFDFE->DBEDFAEDBF
BBBCF->ECAFEDBADC
DEDAA->EFDCFCFEFB
FBFCA->BECDEADEBE
BFBEF->ECEDCFDCCA
BFABF->CDABFDAFCB
EBDFA->BFCDAEABDB
CACCC->DFBCFEBAEB
FEDDF->BCFACECBAC
BCCFE->CDDEAFABBF
EFEEE->FAEDADFACB
CFBAF->BDABDEBCEA
FCACA->BEDEFBDEBE
EBAED->FCAFBCDCFC
CCDBE->DADEFACDBF
EBDEF->BFCDAEFABE
CCCBE->FDBAFECDBF
BEEAD->ECDCBABCEB
EDCFE->FCEFFDEDAB
CADEB->FEBCAEFAED
ADEBF->BCCBBACDBE
DEDCD->BCFAEBDEFA
BCDAF->EDBACEFEAB
AADBD->BCFECACDFC
BFFAC->DAEDEABCBF
BBDDF->CFAFEACBEA
DEFEE->FADCEAFAFB
ACDEC->EDBAEFDCEB
BBBBC->DECDEDCDAF
AAFBE->CFBCCBAFBA
CFDEA->FEABFCDCED
BADEE->ECFEAEFABF
DCDBE->CADEFCAFDB
EEAEA->FCFACDFAED
FCEDF->ADBAFBEFCB
BFCEA->CDABEBDCED
CFFFD->BFABADABEB
ADFEE->CFCBDCDCBA
ABFDA->CDCDBECBFD
BCDEB->CFBAAEFAED
CAEBB->DABCBACDED
EEBAE->ABDCFEBCBA
ADDEF->CDCBCEDCCB
FDBAC->CBCBECFEDA
FBCFE->CBAFEBEDAD
AECFA->BCDCEBEDDC
ECECD->BFDEBFDEAE
BFBFB->CFEDCFEDCF
EBBEE->CDAFCDFACB
EADEB->BABCEBFACD
ABABA->BEAFBCAFCF
BDFBF->EDEFCBAFAD
ECDCB->BABACEBACD
FEAAF->BCFAEDFEBC
DFFDB->EBABACEFEC
BADEA->CDBCFCDCED
DDDCB->EFCBCEBACD
ACBAE->DBDECDBCDF
BADFD->ACFEFAEDAE
FDABF->BCEFDBAFCB
DCDBC->FCBACEAFFD
CDFFB->DAEFBCABFE
ADADC->BDCBEDCBDE
AEABA->CDFAEDAFCD
FEFAD->ADFABCBCAE
FEFEA->CADCABDCED
DDBDC->AEEFEDEFEB
FEAFC->ABDCEDEDFD
DDFDC->FACBCBCBFD
EEEED->FADCDFDCEF
CEDED->BFFAEBFAAE
DCEEF->AEDEBFDCAB
ADFFB->FDEFCAEDCF
ABCFA->BDAFEBEDDC
FFCFE->BEABEBEDAD
BACDC->DEBCAFEFDE
BEAEE->DADCEDDCBA
ADDFB->CFCBCEABDE
DCDFB->AEDEAEABEC
FFCCF->DEEDEBDEBE
CBCAC->FDAFDEBCBF
ABAAC->FBCDDCBCAF
BCFBA->DADEBECDDC
FFADE->BEABFDEFBF
BECFF->CFDCDEABDC
FBEBC->ADAFABAFFE
ADCDF->CDCBEBCBDC
CCABE->BDBABCAFDB
DACFA->AEBCFDEDBC
DABDD->FAFEEDEFCE
FBEAA->CACDABFECF
EBDFB->FCAFEAEDAC
EFEEC->BFEDBADCFD
BADAF->DABCAEBCAB
AADBB->DBFEAECDCF
CAEEF->DEBCDFDCCA
EBBBF->DBCDCFAFAB
CADDB->EFBCAEEFED
ADCCA->DBEFDEDEFB
ADACE->BCCBFDBABF
EBEFB->FACDADABAE
BAEEF->CDBCDFDCCA
CDDCC->ABEFAEDEDA
ABCCF->BEAFFDBACA
BFAEF->DAEDDCFADC
FFEFC->BEABBAEDAF
DDFFB->EBEFBCABFE
BDECB->FAEFADDEED
BFBAF->ACABDEBCEA
EFBAE->CDEDECFEAB
CEEBA->DEFAFBCDFB
ADCEB->CFCBEBDCAE
BAFBB->CDBCCBAFEC
DBECE->BACDABBABA
FFCFD->EAABDEABCE
FBBEA->BECDFEFACD
CCACB->FDBACDBAEC
DEAAE->AFDCDCBCAD
ADECA->BCCBBABADB
BECBB->CFDCDECDFE
CEEEC->DAFAFBFAFD
DFBEB->EFABDEDCAE
BACAC->AEFEFDFEDA
BDFDE->ECEFCAEFBF
BAEEE->CFFEFADCDF
EDCFA->BACBFDEDBC
CFBDC->EFEDFEEFDE
FDAEE->CAEFCDFABA
CDDEC->DAEFEADCDA
AAFAF->BEFEABFEBE
ADABA->BDCBEDAFCD
FFEDD->ABEDADEFAF
FFBCC->BEABAEBADE
FACCC->BEBCBFDEFD
FEBBF->BCFAECAFBC
EFDED->BFEDAFDCAE
CDDEB->FDCBEFDCAE
FBDEB->DCAFEBFACD
FEDBD->EAFAAECDAE
EAECF->ABFEBFDEBC
FBEEB->CBAFBADCFE
BAFEC->ECFEBCFAEB
FAFCF->ACBCBEDEBE
ECFEE->BFDEBCFABA
DDBDC->AEEFEDEFEB
CFEEF->FEABDFDCCA
CCBCF->EBDEEDBADC
DCFDF->BADEBCEFDC
AFACB->DCABEDBADE
BFEBD->ACABBFCDAE
BACEA->CFFEDFDCFB
AECDE->BCDCEBCBBA
DAAAD->AEBCBEFEFA
DCBCB->EBDEECBAED
CCBEF->FEBAECDCAB
DEBFB->EFDCAEEDEC
FDECA->DCEFBFDEDC
EEBDF->CBDCECEFCA
BDEEC->FEEFBFDCEF
DEFFA->FCDCCBEDFB
EDDEE->CDCBAEFABF
CDBDE->AFEFEDEFBA
CBECF->FECDBFDEBC
BEECA->CFDCFCDEDC
BDDFC->ECEFEBABDE
FCEDB->CBBABACBEC
CFDBF->EBEDFCAFBE
FFCBA->BEABEBCDFB
EABEC->FAFEECDCEF
DDFAC->EBEFBCBCAF
FBEBD->ABAFABAFBA
CAFBF->FDFEBCCDBE
BECBC->FEFADACDEF
AAADD->DCBCDCEFAF
BCFFE->DADEBEABBA
EBEFA->FCAFABEDFB
BEACF->CDFAFDBABE
ACCAD->DBDEDABCFA
BBDDC->DECDBAEFDE
CBCBD->FDAFDECDCA
CBABA->DACDDBAFDC
FBBEB->CACDCFDCDE
FDDEA->BECBCEDCED
AECDD->BEDCEFCBFC
FFDAF->CAEDFAFEBE
DFCBC->EBABDECDBF
AFDBF->CFABFCAFBE
BCEFA->ECBABFEDBE
EFEBE->FBABADCDAD
CEDAB->FEFAFCFEED
CBEFD->EFCDBFEDAF
ADDCD->FBEFEABAFC
AEACE->BEDCBEBAFB
DFCCA->CEABDEDEFB
EACCF->CBFEDADEAB
BCECA->EDBABABADB
EBEFB->FACDADABAE
EBFCC->FCAFABDEAF
EDEFA->FBEFBAEDFB
EFDCF->ABEDAEDEBC
ECFAB->FCDEBCBCFE
EEEBE->BFDCBACDBF
BAECC->AEFEBABAEB
BCCFF->EDBAEBEDEA
ACBCA->DBDECDDEFB
ADFEA->BECBACFADC
EEEBF->DBFABFCDCB
ABBCF->DBAFCDDEBE
FFDEC->BEABCEDCEB
FCBCB->ADBACDDEED
EEDAE->BFDCFAFEAD
AFDAE->CFABFCFEAD
FCEFF->ACBABAEDBE
DAEFB->AFBCADABAE
FADEA->DCFEAEFACF
EFCFD->ABEDAFABEB
CACDD->EBFEAFEFEB
BCDBE->CFBAAECDAB
CDDCC->ABEFAEDEDA
BFDAB->CDABCEFEEC
CFDDE->AFABEBEFAB
AECAB->EDDCEFBCFE
AFDBF->CFABFCAFBE
AAEBC->EDFEABAFFE
ADDCB->EDCBEBDEEC
AADDF->BCFECAEFBE
DCBEC->AEDECDFABD
DCBFE->CADECFEDAB
EEBFB->FADCAEEDEC
BFFDE->ACABACEFBA
EAFFC->ADBCCBEDAF
CBDDC->EFCDBAEFDE
DBCCF->EBCDFDBACA
EBBEC->FCAFCFDCDE
CCEFB->DADEABEDED
AAFBA->BEFEABAFBC
DDABB->AEEFCDCDED
FFAEE->BCABEDDCBA
EECAF->BFDCEFBCEA
EADCB->ADBCFCBAEC
BEBAE->ACFACDBCDF
DFDFD->EAEDEBABEB
CDCCC->DECBEBDEAF
ABCFE->DCCDAFABBF
FEEBC->EAFAFBCDAF
BEEFC->ECDCBAEDAF
CEDBA->DAFAAECDBC
ABCCE->DBAFDADEAB
BBCEA->ECAFDEFACD
EDFCF->CBEFCADEBC
BABDA->CFFEECEFCD
ADEBC->BDCBDFAFFD
BFABB->DEABEDAFED
DFBCF->BAEDCFBABC
CECEE->DAFADAFAFB
BAEEA->EDBCADFAFD
BECAD->ACFADABCFA
ACEFD->DCDEBAEDAE
ECCFC->BFDEDAABDE
ABADC->BEAFBCCBEB
BDABD->FEEFCDCDBA
CAFDA->EBFEBECBFD
AABDE->CFBCAECBFC
BFCFB->CDABEBEDFE
ADBDC->DBEFEDEFEB
BBBDA->ECAFEDEFBE
FAAAB->EABCEDFECD
EADDB->DFFEFACBEC
EEEAF->CBDCBABCBE
AAEEB->CDBCADFADA
AADFB->EDFEAEABEC
FAFEC->CAFECBDCFD
DFEFE->CAEDBAEDBF
CCFAD->FEBADCFEAE
AEEED->BCDCDFDCEF
CAFED->BFBCADFAAE
EFEBF->BFEDBACDBE
BADDB->DEBCAEEFED
DCDFC->EBDEFAEDAF
ABFFE->DBAFCBEDBF
AFBFE->FBABDEABDF
AEBBC->BEDCECAFDE
DECED->AEFADEFAAE
BFBBE->CDABAEAFAD
FFDDF->DEEDAFCBCB
DAABD->EAFECFCDCA
AAFBF->DBFEBCCDBE
DDDBB->AFCBFCAFAC
DEDBF->AEFAEBCDCB
CBFAF->FDAFBCBCEA
DEAAC->EBFACDBCAF
FDFDA->DCEFCAEFCD
BABDD->ACFEECEFEB
CAEBF->EBFEADCDEA
ABCFC->BEAFFDEDFD
DCCCF->AEDEDADEAB
FBDAD->ABAFEAFEBA
ACDFD->BCBAAEABAF
FDCBF->CAEFDECDEA
FEFFC->ADFABCABFD
CDCFF->DECBEBEDEA
CEBFE->DFDCEDABDF
EFDAF->BFEDAFBCEA
AACCC->BDBCFEBAEB
BCBFD->ECBAEDABFC
DCEDE->AEDEBFEFBF
FFEFE->ADABBFEDBA
EBDFD->BACDBAEDFA
BBEDC->DACDADEFBD
FDBAC->CBCBECFEDA
EAEFC->DFFEFAEDBF
EECED->BFDCEFDCAE
CEBCF->FEFACFBABC
BBCEE->ACAFFDDCBA
AFFAD->DBEDCBFEBA
DBDDA->EFCDCAEFDC
DACFD->BCFEFDEDFA
BDBFD->CECBCFEDFA
AAFFD->DBFEBCABFC
FDBAC->CBCBECFEDA
CADAF->EBFECABCAB
FADAC->ABFECABCFD
BFAAE->CDABFDFEBA
CDADD->FDCBCFCBCE
CBEDC->DFAFBACBFD
CAFAA->DEBCCBFECF
EEEAA->BADCADBCED
CEECF->FDDCBABADC
ABDCE->BEAFEABADF
CBADE->FECDFBEFAB
DCBAF->EBDEECFEBC
BCAEF->CDDEFBFABC
DEFBD->AEFABECDCA
CADDC->DFBCEBEFFD
AAAEF->CDBCDCFADC
CFABB->EFEDDCCDED
DFAAD->EBABCDBCAE
ACFDE->BEBABCEFCB
DCEAF->CEBAFBBCBE
CBAAF->DACDDBFEBC
BECDB->CEDCFDCBED
BBCBA->EDCDAFCDBC
AADBD->BCFECACDFC
FFCCC->CAEDFDBAFE
FEFAD->ADFABCBCAE
CCFFF->FDBACAEDCB
FFBFB->ADABDEABFE
FFFCF->CAEDCBBADC
DDFAF->CECBACBCBE
BBCBD->ECAFDECDCA
AEACB->CDFAEDBADE
BEFBD->ECDCABAFEA
DAFAA->EFBCCBFECF
CFFDD->FEABCBCBFC
AEBDC->BDFACFCBDE
FEFAB->ACFACBFEAC
ADBDD->BECBCDEFEA
CDFEC->ABEFBEFAEB
BCBFF->CDDEEDABCB
BCBAC->DEBAECFEDA
ACBBB->EDBADECDED
ECFBB->BFDEBCCDED
DDAAE->FACBEDFEAB
DCABF->EABABEAFAB
DBAFC->FCAFCFABFD
FBEBF->BCCDBFCDCB
FDFAA->BECBDCFEDC
CFAFD->AFABCDABFC
BBDEE->DACDCAFABF
BFFDD->EDABCBCBFC
DBCCC->FACDAFDEDA
EBFBB->FCAFABAFCF
EDCBE->FBEFEBCDBF
EFEEA->DFEDADFAFD
FBDEF->CACDAEFABE
ABFBB->FDAFCBAFEC
AEFDE->CFDCCBCBDF
FFBBC->CAEDCFAFFD
BECAD->ACFADABCFA
ECDAA->DFBAAEBCBE
AABAF->DCBCFEBCAB
DEBEF->EBFACDFAEC
BFAEC->FEABDBDCEF
BECAB->CDFABDFEEC
DCFBC->EBDEABAFFD
ECDAC->BFDEAEBCFD
ADEAC->DBEFBFBCFD
BFCFC->EDABFDEDFD
EFFBC->DFEDEACDEF
FDBAF->CAEFEDBCEA
EBEEB->BACDBFDCEC
BEEDF->DADCDFCBAC
BFDCF->ACABEBDEAB
ECDDE->FBDEAFCBDF
DFBCE->CAEDECBABF
EBBFB->ADCDFEABEC
ADFBE->BCCBDCAFBF
FADCD->ADFEFABACE
DFEEF->AFABADFAEC
FFDBB->ADABEBCDCF
BDEAD->CFCBBFBCFA
EDDDE->ABCBFCCBBA
CEBAB->DAFACDBCAE
FEBAE->BCFAECFEAB
EAFAF->DBFECBFECA
AABEF->CFBCAEDCAB
FBFDB->ACAFADEFED
CAFBB->DEBCCBAFEC
BBCAA->DECDAFBCBE
BBCBA->EDCDAFCDBC
EAEDF->BABCBFEFCA
DDBDB->FCCBDACBDA
FDEDC->CBCBDFCBDE
FECCD->ABDCEBDECA
DFCCC->AEABEFBAEB
BBFBD->EDCDBECDCA
CFCFE->DFEDAFABBF
DEAFC->EFDCEDEDFD
EFACD->ADABFDBAEB
FAECF->BCBCADDEBE
CAADF->EBFEFBEFBC
CECAF->FDDCEFBCEA
CFBBB->EBEDFECDCF
AAFAC->FBFEABFEAF
FEAED->EAFACDFACE
DEBCE->BADCECBABF
FDBCE->CBCBECBABF
AAAAB->CDBCDCBCFE
DAFCB->EBFEABDEED
FBCEC->ABAFFDDCEF
FFBAA->BEABAEFEBC
DBCCF->EBCDFDBACA
BABBB->DEBCFECDCF
EBFBA->BFCDCBAFBE
DEFAE->BADCABFEAD
CABAB->EBFEEDBCFE
BDDAF->CDEFEAFECA
AECDF->DCFAEBCBDC
BFCEB->FAEDEBDCAE
FDBCF->BCEFDADEBE
DBCCA->EFCDBFDEBC
BECBF->DADCEBCDBE
EDBBA->BFEFEDCDFB
EEAEB->FADCEDDCEC
ECBDA->FBDEDACBFD
EBFFE->BFCDCBEDBF
AECDB->CFDCEBCBDA
CFEDC->DAABBFEFDE
FCEDB->CBBABACBEC
CFAFB->FDEDBCEDFE
BCBBB->CDDEEDCDED
EDCEA->DFCBDEFACD
CADFA->DABCFAEDFB
EADBF->ABFEBACDCB
FAAFE->ABFEFBABBF
FCECC->BEDEDBDEFD
CFAFB->FDEDBCEDFE
DAAFC->AEBCBEABDE
CABDF->FDFECDEFBC
EDEBA->BACBDFAFBC
DAEED->AEBCBADCAE
EEADA->CBDCBECBCD
EBBEC->FCAFCFDCDE
FDEDC->CBCBDFCBDE
FBBEC->ADAFCFDCDE
BBDAC->AEAFAEBCFD
CAFDA->EBFEBECBFD
FEBFD->EAFACDABCE
ADCDE->DCEFBDCBBA
AAAFD->BEFEBEABEB
EADCF->BABCEBDEAB
FCAAB->DCBABCFEED
DAAFF->AFBCDCABCB
ADDBC->FBEFEAAFEB
BCFFA->CFBABCABED
FEBFA->ECFAEDABED
DBAAC->FACDFBFEDF
AEAFD->DCFAEDEDFA
AFEAD->CFABDFFEFA
EBAEB->ADCDDCFAEC
ECFEF->DBDECBDCEA
CACCF->DEBCBFDECB
DFEEE->BAEDABDCAD
FDEBC->BECBBACDAF
CBCAF->FECDAFBCAB
BEBFE->DADCAEEDBA
DDBCA->FCCBDADEFB
CBBAF->DECDFEBCAB
EBEAF->ADCDADBCCB
BCFAE->ACDEBEBCDF
AACAD->BCFEAFBCFA
AEFEB->FDFABEFAEC
BCDFB->ECBAEBABDE
AEDCA->DBDCFABADB
EFBDD->ADABAECBEF
DEECA->EBFAFBDEDB
FCBAA->DCBACDBCED
EFFCF->BFEDABDEBE
AAAEB->DBFEDCFAEC
DAAAB->CEFEBEFEEC
ACECD->DBDEBFDEAE
CDBDA->BDCBDACBFD
ECFEA->CBDEBCFAED
DDDFA->CECBEBABCD
BEECB->CDFACBDECD
FCBAD->BEDEEDBCAE
DAEFD->EAFEBFEDAF
FDABE->CBCBEDAFBF
EFEAB->BAEDBFBCEC
BFDFD->CEABAEABAF
AADDB->CDBCAEEFED
DBBED->EFCDFEFAAE
ADBEE->BECBCDFACB
FEDCE->BCFACEBAFB
CFAAF->FEABEDFEBC
EBFCA->FBCDBEDEFB
EAFEF->BABCBEFADC
BBDDA->CDCDCAEFDC
CBDAE->FECDBAFEFA
EDCAE->BFEFDEBCDF
DBAED->EBCDBCDCFC
BEBBF->ACFACDCDEA
BAAEE->EDBCDCFABA
BCBAF->CFBACDBCCB
CCDDF->FDBAEFCBDC
CFCFE->DFEDAFABBF
AADFD->FBFEFAEDAE
BFFFF->EDABCBEDBE
AFBCD->DBEDCFBAAE
BAEFC->DEBCADABEB
DCCAE->CADEFDFEAB
EBAEE->FACDDCFABA
ADCAC->FBEFFDFEDA
ABFBF->CFCDEACDAD
CFBCF->DEABAEBABE
FDABA->BECBFDAFDC
CCBAB->FEBAECFECD
EBFCF->ABAFBEDEBE
FCADB->ACBADBEFED
DCFBC->EBDEABAFFD
ABACD->DCCDFBDEFA
DADBB->AEBCFACDED
CCCEF->BDBADAFABC
EEFAA->DFDCCAFEBC
FCDEE->BCDECAFABF
BBBBF->CFAFCFAFAB
FFBFF->ACABEDABCB
BEBEA->CDFADADCED
EBEEB->BACDBFDCEC
AABCF->BEFEECBABE
CAEFA->DEBCDFEDDC
ADACC->DBEFCDBAEB
EEAEC->BADCDCFAEB
DECDC->AEFADECBEB
ABEEE->DBAFADFACB
EFACB->BAEDFBDEEC
DCECC->FCBABABAEB
BDABB->ECEFCDCDED
BFCBF->ACABDECDEA
BBABF->ECAFCDCDBE
FDBEC->BECBDADCEB
BCBAA->CDDEEDBCDC
CEDBC->ABFAEBCDFD
DCFEB->AFBADCDCEC
DADCD->EBFEFABACE
EFFCD->ABEDBEDECA
BEEAB->DEDCDFFEEC
FEEBE->CADCBACDBF
CFBEF->FDEDCFDCCA
BBFFF->CFAFABEDEA
AAEBC->EDFEABAFFE
DCFEB->AFBADCDCEC
AEFAB->CFDCCBFEAC
ABFBA->DBAFCBAFBE
CDCAA->DECBEBFEFB
EBCBE->FCAFFDAFBF
DBFFC->FACDBEABEB
CFCFD->EFEDBFABAF
EDCCD->BACBFDBAEF
DAADD->BCFEBCCBCE
BFCCF->EDABFDBACA
FADAF->ACBCEBFEAB
CCCCB->DEDEAFDECD
EEBBE->CDFAEDCDBF
DFEBC->AFABADCDBF
BDDBF->CFCBEBCDCB
EDFFD->BACBCBEDAE
DCACA->FCBADBDEDC
FADDC->BEBCFCCBEB
DAEFC->FAFEADABEB
DBADF->CEAFBCCBDC
ADCEA->CDCBEBDCED
DDFDE->AEEFCAEFBF
ACCCC->DCDEBDBADA
EAEBA->BFBCBACDFB
AACBF->DCBCAFCDCB
ECAFC->DFBABCEDBF
BEEBA->CDFACBAFBC
BAEBE->ACFEFACDAD
DDCAA->EFCBEBFEFB
DEDAC->FADCAEBCFD
CBBEC->DACDCEDCFD
ECFFC->BABADCEDFD
FAEEB->EABCDFDCDE
EECAE->FBFAFDFEAB
BFEAC->DEABDFFEDF
AEAFE->FBFACDABDF
CECBE->BDFADACDFA
BBFAC->EDCDBEBCBF
BACBF->EDBCAFCDCB
DEFCD->EADCBEDECA
BACDE->ECFEDAEFAB
FADAA->CAFEFCFEFB
EEDDE->CDFAEBEFAB
EFBBA->DFEDFECDBC
BDAED->CECBDCFACE
AFBAE->DCABFEBCBA
ADACD->BECBCDBACE
EFCDC->ADABEBCBEB
DAFBA->EBFEABAFBC
EBAFD->BFCDBCEDFC
AADCA->CDBCAEDEDC
DFEEE->BAEDABDCAD
AAFFD->DBFEBCABFC
DFFBE->AEABADAFAB
AFBAB->DBEDCFFEEC
EFBBD->FCABDECDBA
BBDDA->CDCDCAEFDC
DBBFF->AFCDEDABCB
CCAEA->FEBADBDCBE
ADEED->DCEFCBDCFA
ACCFB->CFDEAFABDE
BFCAC->FEABEFBCAF
ACFFE->CFDEBEABBA
DBAFD->AECDBCEDFC
CEDCB->DAFAAEDECD
FEDBB->DCDCFACDED
FAEFC->EABCDFEDBF
EACED->ABFEFEFAFC
CEDDD->AFDCFACBFC
ACACC->BEBABCBADA
CAFFA->FEBCEAABCD
BEAFA->ECDCBEABCD
BFECD->EDABDFBAAE
EBABF->BFCDBCAFBE
FBFDA->BCCDBECBFD
CBBDB->DACDCECBCF
FFBAA->BEABAEFEBC
FCEEE->BEDEDBFABF
CADCA->BDFEFABADB
EACCE->FCFEDFBADF
CDFBC->FDCBCACDFD
ADFDC->FBEFBCEFBD
BDBAD->ACEFCFFEFA
AECFA->BCDCEBEDDC
ABFEE->BEAFABDCDF
ECABF->ADDEFBCDEA
ACEFB->FDBABFEDEC
EDCFA->BACBFDEDBC
BCBCE->ACDEEDBABA
BEDAE->ECDCFAFEAD
EADEE->BFBCFADCAD
AFADA->BEABCDCBFD
CEACB->EFDCDCDEDA
DBECD->EBCDABBACE
EDFEF->BFEFCADCAB
AFBEB->EDEDCFDCDE
CDBAB->DECBDABCFE
EDFBF->BACBCBAFAD
DECBA->AEFADECDDC
FBFAB->DCAFBCBCFE
DADAA->AEBCFAFEFB
EEDAA->CBDCFAFEFB
DCFEC->FABADCDCEF
DADCE->BAFEFABABA
AACBF->DCBCAFCDCB
ADDBF->BECBEBCDCB
BEBAD->EDFAECFEAE
EADEE->BFBCFADCAD
DBECC->AECDABBAEB
CDDEF->BDCBCEDCCB
BACFC->FEBCFDEDFD
ACABE->FBDEBEAFAB
CFBCA->FEABFEDEDC
DADCB->FCFECADECF
FDBEE->ADEFEDFABA
EFBAC->FCABDEBCAF
FDFDD->BECBDCEFEB
EBEAE->ABAFDBFEBA
AABDA->BEFEECEFCD
FCBEC->CADECDFABD
DAFAD->EAFECAFEFC
BAEBF->DABCADCDEA
DACBA->CEFEDFAFBE
BFCAB->CFEDFDFECD
CBDAC->DACDFAFEAF
AEEBC->FBFAFBCDAF
CAFAD->EBFEBEBCFC
DDDDA->AEEFEBEFBC
BBDCD->ECAFEBDEFA
ABECF->DCCDBFDEBC
CCBBD->EFBAECAFEB
DEECD->FADCADDECA
CAFBF->FDFEBCCDBE
CFCAE->BDABDEBCDF
DFEBA->EBABBFCDBC
ECDBB->DFBAAECDCF
CCEBF->FEBABACDBE
ABDFF->CFCDCAEDAB
BECDF->EDFAEBCBDC
FFEAF->ADABBFBCAB
EFACE->BFEDBEBAFB
CFCFB->DEABEBEDFE
EBDAC->FCAFEAFEFE
BFDBE->ACABEBCDAB
DEACE->CAFACFDEDB
FBAED->ADAFBCDCFC
DFEDA->FCEDADEFDB
CBFFF->DACDADABAC
CDBFB->FECBECEDCF
ADFCE->BECBACBABA
CFFAE->DAABACBCBF
ECCDB->FCDEDAEFCF
EFBBD->FCABDECDBA
EAFEE->FAFEABDCDF
EEAED->ABDCDCFACE
EEAEF->BFDCBEDCAB
FEEEE->CBDCADFACB
EDCEB->ADEFBDFACD
AEBAA->DBDCECFEDC
DFAEC->EFABCDFAEB
DABEE->FAFEEDFABA
AEFAE->BCDCCBFEBF
BFFEB->ECEDCBDCFE
CEABA->BDFACDCDFB
AFFAF->BCEDEABCCB
BDEDE->DACBBACBDF
FDCAC->EAEFFDFEDA
ACDBA->EFDEFCAFCF
BEABB->CEDCDCCDED
FEBFF->CADCECEDCB
EBABE->FBCDFBCDAD
ACAAC->DCDEDBFEDA
CCDDB->DEDECAEFCD
BDEBE->CFCBBFCDAB
FFEDF->BCABDFCBAC
DDDCD->FACBFCBACE
EBCBE->FCAFFDAFBF
ACABC->EDBACDCDAF
DAEFC->FAFEADABEB
CBFDF->FECDBECBDC
EEBBE->CDFAEDCDBF
AEBFD->FBFACDABCE
DFFBC->FAEDBECDBF
AFCAE->FBABDEBCDF
FEBDB->EAFACDEFCF
DAAAF->BAFEBEFEAB
CDBAB->DECBDABCFE
AABDB->EDFECDEFCF
DEBBE->AFDCFECDAB
BBDEC->EDCDBADCEF
BABBC->DABCFECDFD
AEEDC->EDDCBACBFD
BCBAA->CDDEEDBCDC
CEBEB->FEFACFDCDE
CCFCA->BDBABCDEFB
EBDCD->BFCDAEDEAE
DADAF->EAFEBAFEAB
BCFEB->FADECBDCFE
CCFBD->AFDEBCCDBA
AFFCA->BEABACBADB
BBCEA->ECAFDEFACD
ECBCA->BFDECDDEFB
BBFDB->CEAFADEFED
FAEDC->CAFEBACBFD
DEBEE->AEFAEDFABA
EFBDA->CBEDCFCBCD
ADFAF->CDCBDCFEBC
ACBDF->CDBAECEFCA
DBDFD->BCAFAEABAF
ADDBC->FBEFEAAFEB
FFAFC->ADABCDABFD
EDDFF->BACBFCEDEA
ABEEB->DCCDBFDCEC
DDCBD->FACBFDAFEB
FDBDE->ABCBDACBBA
CEACA->FEFADCDEDB
CBDDB->FECDBAEFED
BDDAE->CFCBEBFEFA
EBFFC->DFAFABEDBF
ABADD->BCAFCFCBCE
EEFDE->FBFACBCBDF
CDDCD->EFCBFCBACE
FFCCC->CAEDFDBAFE
FEBEC->EAFACDFABD
FBCDA->ECAFDAEFBC
EDBEA->BACBECDCBE
AAFEA->CDBCEAFACD
AABFC->BEFEECEDFD
DDACD->EBEFBCBAAE
DECBA->AEFADECDDC
EEEBB->BADCADCDFE
ACEDE->DBDEBFEFBF
FFABE->ADABCDCDBF
EDFED->ABCBCBDCAE
BECBE->ACFADACDFA
ABFCA->BDAFADBABC
AFBEB->EDEDCFDCDE
DCFBC->EBDEABAFFD
BEAAF->ACFACDBCEA
ABADC->BEAFBCCBEB
FFABA->CBEDFBCDDC
FADDA->CBFEBAEFCD
CDDAC->DFCBAEBCFD
FBCCE->CACDFDBAFC
DBBAB->CEAFCFFEEC
DFEAF->EBABBFBCAB
BDEBF->CDEFABAFBE
CBFCE->FECDBEDEDB
AEBAF->CFDCAEFECB
ACBDD->BCBACDEFEA
CEBBE->FEFACFAFAB
FECEF->ABDCEBDCCB
EEAEA->FCFACDFAED
EEFDB->FADCCBCBEC
BDBCE->EDEFECBABF
CFEDA->EBEDADEFDB
FBEDC->BECDADEFBD
ADDCC->DCEFAFBAEB
DEFBD->AEFABECDCA
FBBBA->DCAFEDCDFB
DEBFF->AEFAEDABCB
BCEBE->CDDEDBCDAB
AACDB->DCBCAFEFED
DAADF->EAFECFCBDC
FEACE->ADFACDBABA
DFDAE->FCEDFCFEAD
CDCAB->FECBFDFECD
BCEBA->DEBABACDFB
ADAFD->FBEFBCEDFC
DBFDC->AECDCBCBFD
DEDBB->EFDCFCAFAC
ECABF->ADDEFBCDEA
BDADD->ECEFCDCBCE
CBCDE->DFAFEBCBBA
ADCFA->EFEFDAABCD
FAECA->BEBCDFBABC
BBDBE->CDCDCACDBA
CFBEC->ABEDECDCEF
BDECE->ECEFBFDEBF
FBDDD->BECDCAEFAE
EAEBE->ABFEBFCDAB
AFABD->DBEDBCAFBA
FCEBE->ABDEDBCDAB
EDEDD->ABCBDFCBEB
DACCF->BAFEDFBACB
BFEFB->DEABDFEDFE
AFDCC->BEABEBDEDF
BBDEA->CFAFEADCFB
FCFEA->DCBABCFAED
EDCEE->FACBEBDCDF
DFAAB->FCEDDCBCFE
FEFDA->ECFABECBFD
CCBEC->FDBADEDCEB
BDDEE->EDEFCEDCDF
ACFCC->DBDEBCDEAF
CBFBC->DECDEACDEF
ABAAC->FBCDDCBCAF
BEAFE->ACFACDABDF
BAEDE->CDBCDFCBBF
AADFA->BEFEFAEDFB
BCFBE->EDBADCAFBF
CDDAB->EFCBFCFEED
BDBDA->DECBECEFCD
FEDAF->ADFAAEBCAB
DEFDC->AFDCEAEFFD
CBCAC->FDAFDEBCBF
FBEFA->ECAFADABFD
BEEAD->ECDCBABCEB
FDCCD->CBCBFDBAEF
DEBDA->AFDCFEEFCD
CACFB->DABCFDEDCF
ABDEB->EDAFEBFACD
BBCDD->ACAFFDCBEF
AEBBC->BEDCECAFDE
ABCEB->FDAFDAFACD
ACCEE->DCDEBDFAFB
AAEAA->BEFEFAFEBE
AACFF->CFBCBFABAD
DFECE->FAEDBFDEBF
AFBFB->FDEDECEDCF
DFFAE->CAEDABFEAD
CBBBE->FDAFEDCDBF
CCCEC->DADEDFDCDA
DFDAA->EBABEBFEBE
ADCBF->DBEFDECDEA
DBFEA->AFCDBEFAED
BFACE->ECEDBCBAFB
DCCEB->AEDEDAFACD
DBBAB->CEAFCFFEEC
FDFCC->BECBDCBADA
BCAFB->FADEBCEDFE
ACABF->CFDEFBCDEA
EDFDB->BACBCBCBEC
DEDBF->AEFAEBCDCB
ECDCF->DBDEFCBADC
AAEAC->DCBCADBCBF
CEAEC->ABFACFDCEB
ECAAD->ABBADBFEAE
CFDFD->EBEDFCEDFC
BFABC->DAEDDCCDAF
ACEFF->CFDEDBEDAB
BBDFF->DACDCAEDAB
DADBF->CEFEFACDBE
CBDFF->EBCDBAEDCB
BDEAC->ECEFBFBCFD
AAEFD->CFBCDFEDFC
BFDCD->FEABAFBACE
BCACE->EDBADBDEBF
BABFC->AEFECFEDFD
DCCAA->AFBAEBFEFB
ADADD->DBEFCDCBCE
FBCDD->EACDEFCBFC
BEDEE->CDFAAFDCAD
DEFEA->AEFABEFAED
DBFAF->AECDCBFECA
CDEAB->EBCBBABCED
AFBCB->CDABFEDECD
BBBFA->DECDEDABED
AFFAC->BDABEABCBF
FCDEF->ACBACEDCCB
FECFA->DCDCEFEDDC
AFEAE->DBEDABFEBF
DFAFA->FCEDDCABED
DDBBF->EACBCFAFAB
CAEEA->FEBCADFAFD
CABBC->DFBCEDCDAF
FBDBA->BCCDBACDBC
FCCBA->DCBADACDDB
CBDBA->BDAFEAAFBE
FEBEB->CBDCFEFACD
BBFCB->ECAFBCDEED
DFEEF->AFABADFAEC
FBADB->CACDBCCBDA
FCAFD->BEDEFBABEB
FCCBA->DCBADACDDB
AEEEC->BEDCBADCFD
EECAB->FADCEBFEED
ACECF->BCBAFBDEAD
FFFDA->CAEDCBCBED
FDCBF->CAEFDECDEA
EDAEC->DFCBCDFAEB
DDDDC->EFCBCECBDE
BFDCE->EDABFCBABA
DBBCD->FACDEDBACE
FDFCA->CBCBCBBADB
CBCAC->FDAFDEBCBF
DFEBC->AFABADCDBF
EAAFB->ADBCEDEDCF
BACBA->DEBCAFCDBC
CABBC->DFBCEDCDAF
DDEDC->AFCBDFCBDE
CFCAE->BDABDEBCDF
ECBBA->FCDECDCDDC
EABFD->FAFEECEDFA
CFEFC->DFEDBFEDEB
EAFDD->FAFEABCBCE
BAADA->ECFEDCEFDB
ECECA->BABABABADB
FFFEC->ADABACFAFD
DBDBB->FCAFBACDCF
EDCFC->ADEFBDABDE
CABDE->DFBCEDEFBA
DEFCD->EADCBEDECA
DABCF->EBFEECBABE
BECEE->CFDCDEFAFB
EEDFF->CBDCFAEDBE
AFCEA->BCEDBFFACF
ABEDA->EFCDBACBED
DEBDE->CAFAEDEFBA
BDFBD->CFCBACAFCE
EEACD->BFDCBEBAAE
AADDB->CDBCAEEFED
CBBBA->DECDFECDBC
FCFEB->CBBADCDCEC
DDBFD->EACBCFEDFA
EBADF->ABAFCFCBDC
BDADB->DECBEDCBCD
ACEAD->BCBAFBBCEB
AEAEE->CFDCEDDCBA
DEDBA->EBFAAECDBC
BABAF->EDBCFEBCAB
CDDBC->EFCBFCAFFE
DBEDF->BACDABCBCB
FDCED->ADEFDEFAAE
EBAEF->BACDFBFABC
CEAFD->FEFADCABFC
EAADA->BFBCBECBCD
BAFCF->DABCEADEAB
EACBE->FAFEDFAFBA
ABBBB->DCCDEDCDED
FADCC->CAFEFCBAEB
ECACE->CDBADCDEBA
BCDCD->CEBAFCBACE
EFBFE->ABEDEDABDF
CFBEA->DAABDEDCED
CCBCD->FEBAECBAEB
EACFB->FCFEDFEDED
BAACF->ECFEDCDEAD
CBDBA->BDAFEAAFBE
AEFCF->BEDCABDEBE
FEFCA->DCDCABDEFB
EBDBF->BACDBACDCB
AEADB->DCFAEDCBCD
DADFB->EFBCFCEDFE
FFEAD->BEABBABCEB
DBCAD->EBCDFDFEAE
FBAAA->DCAFCDBCDC
BDFDB->FAEFBECBDA
ECFCC->BFDEBCDEAF
CECCF->BDFADADEAB
FAABB->CBFECFCDFE
ADFFB->FDEFCAEDCF
EEADD->ADFAFDEFEB
ECAAC->BABADBFEDA
DFDFE->AEABAFABAD
EBEDA->BACDBFEFCD
BEEBC->DEDCDFAFFD
DDBAE->FCCBDABCAD
BBFEC->DACDEAFADA
ACABA->DBDEDCCDFB
FFEBB->DCEDABAFAC
FEFAF->DEDCBEBCCB
CFECA->FDEDABBADB
DBAEA->CEAFBCDCED
CFAAD->BFABDBFEAE
EFADC->BAEDFBEFFD
DDFEE->FCCBDCDCBA
DDDDA->AEEFEBEFBC
FCFEC->EADEABDCEB
BADCF->EDBCAEDEBC
EDCFA->BACBFDEDBC
EFCDD->BFEDEBCBCE
AFDBB->FDEDAFCDED
AEADD->CFDCEDCBEB
ADBFA->BCCBDAEDDC
DBBBD->EAAFECAFEB
CFBFD->FEABFEABAF
DBCEE->FACDAFDCBA
EBEBE->CDAFADCDAD
CDADD->FDCBCFCBCE
FDEAE->ABCBBABCBF
FAFEC->CAFECBDCFD
EEDCC->FADCFCBAEB
CDAEF->DAEFBCDCCB
ECCCA->FCDEDADEBE
BACBE->CDBCBFCDBA
AFDDA->CDABFCCBFD
ADDAC->BDCBFCFEAF
AEEEA->BDFADFDCBD
DCECB->CEBAFBDEDA
CCCAA->FEBAEBFEFB
FDECE->CAEFBFDEBF
CDBAB->DECBDABCFE
FAEDB->ACBCBFEFED
BCFDC->DADEBECBEB
CCCBD->EBDEAFCDAE
DADBA->FCFECACDBE
CFEDC->DAABBFEFDE
FDCBA->ECEFDACDDB
CCCFA->BDBADAABCD
DBABF->AECDBCAFBE
BBDEC->EDCDBADCEF
BAFAE->ECFEBCBCAD
DBDFE->FACDBAEDAB
FCDCD->BEDECADEFC
CDFDB->FECBCBCBEC
DFACD->EAEDCFDECA
EBEEA->CBAFABDCDC
DEDDC->EBFAAEEFDE
BBFAB->CDCDEABCAE
CBEAA->FDAFBFBCBE
DAABF->EBFEBEAFAB
CDDCD->EFCBFCBACE
BCCED->FEDEDAFAAE
DBBDB->EBCDCFCBCD
ACADA->CDBADBEFCD
ADAFD->FBEFBCEDFC
DCBBF->AEDECDCDEA
EDCED->FCEFFDDCFA
BDACD->CFCBCDBACE
FBBBF->ADAFCFAFAB
DEAAC->EBFACDBCAF
DFCAA->AEABEFBCDC
CFBFD->FEABFEABAF
AEBFD->FBFACDABCE
FACEF->CAFEFDDCAB
AFCDE->BEABDECBBA
DBAFB->CEAFBCEDFE
DBAAA->EFCDDCBCDC
BACEB->CDBCBFFAED
AFEFB->CDABDFEDFE
FDEFD->ABCBBAEDAE
EDBBE->ABCBECAFBF
FEECA->ECFABFDEDC
DFBFD->BCEDECEDFA
BBCBB->DECDAFCDCF
FCDCC->EADEFABAEB
FFAAE->ABEDDCBCAD
EDEAE->FACBBABCBF
FDAFB->DCEFCDABFE
DFCBC->EBABDECDBF
EBBBC->DFAFCFAFFD
AAFDE->DCBCEAEFAB
EBDEC->BACDBADCEF
DEBDA->AFDCFEEFCD
FCEDF->ADBAFBEFCB
AAAEC->BEFEBEDCEF
AADDF->BCFECAEFBE
FDEBD->CAEFBFCDAE
FEECF->CADCBABADC
AFECC->EDEDABBAEB
FFAFA->BEABFDEDBE
EAAAB->DFFEBEFEEC
ACEEF->DBDEBFDCAB
EDAFE->FBEFBEABBF
CEEAA->FEFADFFEBE
AFFCF->DBEDCBBADC
FAEAA->ECFEBABCFB
DFDDD->EBABEBEFEA
AEDFC->BDFAFCEDBF
DBAAB->AFCDFBFEEC
ADEBB->CDCBBACDED
EACAE->CDFEFDFEAB
CEFAA->BDFABCBCDC
EFFDB->FCABACEFEC
CABDE->DFBCEDEFBA
DEBCF->AFDCFEDEBC
EECAD->ABDCFDFEAE
DECFA->EFDCEBEDDC
BBDBC->ECAFEBCDFD
DCDFF->CEBAAEABAD
DECBD->BCFADECDCA
EDBEE->FCEFCFDCFC
ECCCD->ABBAEBDECA
EABEC->FAFEECDCEF
ECBAE->BFDECDBCDF
ADDFF->DCEFAFABEA
BAFBB->CDBCCBAFEC
EDADB->DFCBCDCBDA
BECFB->FAFADEABAE
EDCCA->BFEFDEDEFB
FADDF->ABFECAEFBE
FAADC->ABFEFBEFFD
ADCAF->BECBDEBCCB
DEBAD->BCFAEDBCAE
CDEDF->FDCBFCEFBC
EDCEC->BFEFDEFADA
BCEDF->CFBAFBEFCB
CECAA->DAFADABCBE
CFBAF->BDABDEBCEA
BBEDD->ECAFBFEFEB
CDAEF->DAEFBCDCCB
BECDF->EDFAEBCBDC
EFAFF->ABEDFBABAC
DAFBB->EFBCCBAFEC
AAAEC->BEFEBEDCEF
BEEBF->CFDCFCAFAB
CEAFC->DEFACDABFD
FBCFF->BCCDAFABAC
BAEBD->EDBCADCDCA
DAEDB->FCFEADEFDA
FAABD->BEBCEDAFEB
ADEDA->BECBBFEFCD
CEFDD->EFDCEAEFEA
BABFA->DABCFEABDB
BFFCD->ACABACBACE
CFAAF->FEABEDFEBC
DDCFF->BAEFDEABDC
FBFCC->ADAFABDEAF
BDFBE->CDEFBCCDBF
FAFCC->ABFEBEDEAF
DEFCC->FADCEADEDF
EAACC->BABCFBDEDF
EEEEF->ABDCADFAEC
FCAFD->BEDEFBABEB
BDBAD->ACEFCFFEFA
DCCBB->AFBAEBCDED
ABEDC->BDAFBACBFD
CBDBB->EBCDBACDCF
DCBCD->BCBACFBAAE
FDECD->BECBBABACE
DADAD->BCFEFCFECA
BDBCF->ACEFCFBABC
DECCD->EFDCEBDECA
FBFAE->BECDEABCDF
DBBDA->AECDCFCBCD
FADFD->EABCFCEDFC
CFBFA->FDEDCFEDBC
EBEBE->CDAFADCDAD
EEEEF->ABDCADFAEC
BFABB->DEABEDAFED
CBCAE->AFCDFDFEAB
CFCAE->BDABDEBCDF
DBCEE->FACDAFDCBA
BACBB->CEBCFECDED
DAAAE->CABCBEFEFA
CDBAF->FDCBEDBCEA
DEAAA->FCDCEDFEDC
CCDBE->DADEFACDBF
CECCF->BDFADADEAB
BEFDA->CFDCCAEFCD
BBBCA->CFAFCFBABC
DCEBC->AEDEBFCDFD
CBBCE->DFAFECBABF
FBAED->ADAFBCDCFC
EBDBD->FCAFEAAFCE
ECEFB->FCDEBFEDEC
ECDCA->CBDEAEDEDC
AFCDB->CDABFDCBED
DBDCA->AFCDBADEDC
BBDBD->CFAFEAAFCE
BEDAA->CDFAAFBCDC
CCACB->FDBACDBAEC
DCFDD->AEDEBCEFAF
CFABF->DEABFDAFCB
FAAFE->ABFEFBABBF
EAEAA->FCFEFAFEBE
DADCE->BAFEFABABA
BADFB->CDBCFCEDFE
BFFCB->CDABDCBACD
CDFCC->DFCBEADEDF
EFADE->FBABDCEFCB
FDACE->ABCBFDBABF
CDCEB->EBCBEBDCAE
CDFAD->AFEFCAFEFC
DFDBE->FAEDAECDAB
FCCAE->ADBADABCBA
CCBAD->EBDEEDBCAE
AFAFD->BCEDDCABFC
ECFDB->DFBABCEFDA
AEFDB->EDDCABCBDA
BEAFA->ECDCBEABCD
FEEFD->ADFAFBABAE
EDAAF->ADEFDBFEBC
EDCBD->ABCBFDAFEB
AAEDA->CDBCADEFDB
CACCA->FEBCAFDEDC
CABDE->DFBCEDEFBA
CBDFC->DECDCAEDEB
EAACB->FAFEBEBACD
ACCAC->BDBAFDFEDA
CCCBE->FDBAFECDBF
ADBCA->BDCBECBADC
BDECA->CDEFABBADB
BACAC->AEFEFDFEDA
FABCD->BEBCAEBAEB
EFBFF->ADABAEEDAB
ADDAF->BCCBCEFEAB
BDAFE->DACBFDEDBA
BEDBE->DADCFCAFDB
FFDEF->ABEDFCDCCB
ECECE->FCDEBFDEBF
DFCEA->EFABDEFACD
AADBA->BDBCEBCDBC
EBCCB->BACDAFDECD
DFCDF->BAEDFDCBCA
FEAFE->BCFAEDEDAB
DBCDF->AECDFDCBCA
AACBD->BEFEDFAFCE
ADFBD->BECBACAFCE
ECFCF->BABADCBABC
EDDBE->BFEFEBCDAB
FBEEC->EACDFADCEB
EFDEA->BAEDAEFACF
EEBBA->FBFACFAFBC
FFDFB->CBEDAEABEC
FDDEF->BCEFAFDCEA
DAABE->AEBCBEAFAB
CEFCF->DAFABCDEBE
DADCD->EBFEFABACE
CCBFE->DADEECEDAB
DEEDB->EBFAFBEFEC
CEAEE->DFDCFBFAFB
FBAFB->EACDDBEDCF
AADFE->CFBCFCEDAD
EEFFB->BFDCABEDFE
CACBD->BFBCEBCDBA
FACBB->ACBCFECDED
FBEBC->ADAFABAFFE
CEAAC->DAFACDBCAF
CDBFD->EBCBDAEDFC
EDCAE->BFEFDEBCDF
EDEED->BACBDFDCEF
DEEFC->AEFABFEDEB
FEDCD->CBDCAEDEAE
EBEAF->ADCDADBCCB
EADAF->ADBCFCFEBE
EFBAD->FAEDFEBCFA
FEDAF->ADFAAEBCAB
FBEDA->CBAFBACBED
AACBD->BEFEDFAFCE
DEBDF->BADCECEFCA
ABFFA->BCAFBEABFD
FFAAF->DEEDBEFEAB
CFDEE->DAABEBFAFB
CFAFE->FEABEDEDAB
EDAFA->FCEFBCEDDC
AADEB->DCBCAEFAED
ABAED->BEAFBCDCFC
EFEAE->BFEDBABCBF
ECBDE->CDBAEDEFBA
CBECE->AFCDABBABA
BEACB->DEDCEDBADE
CFCDE->DAABDECBBA
BBFAD->ACAFABFECA
EFAEE->ABEDFBFAFB
DFAFF->CEABCDABCB
ADFEF->DBEFCADCAB
ADFEF->DBEFCADCAB
CFBBC->FDEDCFAFFD
EADAA->BFBCFAFEFB
FEFFB->CADCABEDFE
CBCBE->DACDEFCDBF
ECBEB->ADDEEDFAEC
FEDDC->ADFAAEEFDE
BFCCB->CEABDADEEC
BFBCD->ECEDCFBAAE
EBEDE->FCAFABCBDF
FEFCD->BEFADCBAAE
ABBBC->FBCDFECDFD
FAEBD->CBFEBFCDAE
ABBAF->BCAFACFEAB
AFFCE->CFABCBBABA
CFEDE->FEABDFCBBF
FCCBA->DCBADACDDB
ACCFA->CDBAEBEDDC
EFBCB->DFEDFEDECD
FFFBF->ADABACAFAD
FCFCF->DEBABEDEBE
BEFFA->DADCCBEDFB
CAAEF->BDFEBEDCAB
DCDAC->AEDEAEBCFD
BEBEC->DEDCAEDCEF
CDFAF->BDCBDCFEBC
EAAED->FAFEBEDCFA
CEDCD->FEFAFCBACE
ABEFC->DCCDBFEDEB
EDDAC->ADEFAFBCAF
DCCFE->BADEDAABBF
BDDCE->DACBCEBAFB
BBBBB->FACDECAFED
ACCBC->FBDEDFAFEB
FAEEB->EABCDFDCDE
CFDDA->BDABEBEFBC
ECCEF->ABBAEBDCCB
EEEDC->FADCDFCBDE
ACACD->BCBABCBAAE
DABBE->CABCECAFBF
ADAFD->FBEFBCEDFC
CEFDF->FDDCABCBDC
DCFAE->FABADCFEAB
CEBAA->FDDCECFEDC
DBCCE->AECDFDBAFC
DAEEB->CEFEFADCAE
FFDFA->DCEDFAEDFB
FAFFC->BEBCCBEDAF
DEFEF->EADCBEFADC
BEFFF->ACFABCABCB
DAFFB->CEFEABEDFE
CAADC->DEBCEDCBDE
EFDCD->FAEDFCBACE
CBAAB->FECDFBFEEC
CFECE->BDABBFDEBF
FBEDB->EACDFACBDA
FEBFB->DCDCECEDCF
BECBD->EDFAEBCDBA
DEAFC->EFDCEDEDFD
ADAAE->FBEFBCFEAD
DEFEB->EBFABCFAEC
BBCED->EDCDAFDCFA
BBEAC->FECDABFEFE
DDBDF->AFCBECEFCA
DCDCD->EABAFCBACE
EAEFA->CBFEABEDFB
BCFAD->EDBADCFEAE
BCCBD->CEBAFDAFEB
BBCDA->CFAFFDCBCF
BDDCA->CFCBEBDEBE
BBAFB->DECDFBABDE
AFCFB->EDEDFDEDCF
BFBFE->ACABDEABDF
BBDFD->EDCDBAEDFA
CECEB->EFDCFDDCEC
DACCE->CABCFDBAFC
CFBEB->DEABAEDCEC
CFDFF->DAABEBABAC
FDACF->DECBCFDEBE
FDEBD->CAEFBFCDAE
EAEAB->FAFEFAFEEC
FBAAA->DCAFCDBCDC
CDADB->EFCBEDCBCD
BBCEA->ECAFDEFACD
FCBBC->CBBAECAFDE
DEFFA->FCDCCBEDFB
DFECC->EFABBFDEDA
AFEFA->EFABADABFD
EDCCE->ABCBFDBAFC
EEEDF->ADFACBEFCA
DEBAD->BCFAEDBCAE
DBAFF->BACDBCEDEA
ACDEF->CFDECAFABE
FABDE->BEBCAECBFC
AFCBF->CDABFDAFBC
FEFDC->CBDCEAEFFD
ADACC->DBEFCDBAEB
DCABA->AEDEDCCDFB
FCBFD->CADECDABCE
FABFA->BEBCAEEDBE
DEBDC->FCDCAECBFE
DAAFF->AFBCDCABCB
BDEFC->AECBFCABDE
EDAAD->BACBEDFEAE
AAFAA->BCFEBEBCED
BFFEB->ECEDCBDCFE
BBBDE->ACAFCFCBBF
BFDEA->EDABFCDCED
BBBFF->EDCDEDABCB
FABDD->EABCAECBEF
DDCDC->EBEFFDCBFE
CEFDD->EFDCEAEFEA
FCDFD->ABDECAEDAF
DDEEA->AEEFBFDCBE
DBBDF->EAAFECEFCA
FFDED->CAEDFADCAE
EABCD->ADBCAEBAEB
EEDED->FCFAAEFAEB
CCDDE->DFBAFCCBBA
DFECB->EBABBFDECD
BEFAB->CEDCEABCAE
FAEDC->CAFEBACBFD
AFFBD->CFABCBAFCE
ADFAF->CDCBDCFEBC
CDFEC->ABEFBEFAEB
EFCCD->FCABDEDECA
EDCEE->FACBEBDCDF
FBEDD->CACDABCBFC
EFBAF->ABEDEDBCEA
BEDFB->DEDCFCEDFE
DBDDE->AECDAEEFBF
FEFEF->ACFACBDCEA
ADEED->DCEFCBDCFA
BEBFF->ECDCECEDCB
BAAAA->EDBCDCBCDC
CCCBA->DEDEAFCDBC
CDFAA->EBCBDCFEDC
BDDBD->CECBAECDAE
BCBCB->CFBACDDEED
BCEFA->ECBABFEDBE
AADFF->DBFEAEABAD
CECDA->BDFADAEFBC
CCAEE->DADEBEDCBA
DAFDE->AFBCEAEFAB
EFEAF->DBEDBABCBE
EFCFA->FCABDEABFD
DECBA->AEFADECDDC
BFBFF->DAEDFEABAD
BCEBF->EDBABACDBE
AFBED->FBABDEDCFC
FECBA->CADCEFCDFB
AADBD->BCFECACDFC
EDAAB->FCEFBCFEED
FCFDF->ABDEBECBDC
FDAEC->EAEFBCDCEB
DBCFF->CEAFFDEDCB
FDBCE->CBCBECBABF
AAFFB->CDBCEAABDE
CADBD->AFBCFACDBA
FEAAB->CADCBEFEEC
ADBEB->CDCBDADCAE
FDFEA->ECEFBEFAED
DDADF->BAEFCDCBDC
FBEDC->BECDADEFBD
DFCAF->EAEDFEBCEA
EDEFB->BFEFBFEDEC
AADED->CFBCFCDCFC
ACBAA->BCBACDBCED
FBAAC->EACDDBFEDA
EDEFE->CDCBADABBA
ABEFE->CFCDADABBA
BBFBE->ACAFABAFAB
FABDF->CAFECFCBAC
BBBBA->CDCDFECDBC
FBEAE->BCCDBFBCBA
FBBBD->BECDFECDAE
CFAEB->DAABCDFAEC
EBCCD->ADCDBFDEFC
EABEA->BFBCECDCBE
BFDDB->CEABAEEFED
FDDDE->BCEFAFCBDF
BFDEB->DEABFCDCAE
AEDDF->CDFACECBAC
BAADC->FEBCBECBDE
CACEB->DEBCBFFAED
FDFFD->CBCBCBEDAE
EBACB->FCAFBCBACD
EDBED->BFEFEDFACE
BFDBA->ECEDFACDFB
CDDFF->FECBFCEDEA
BEADA->CDFAFDEFCD
FEDCE->BCFACEBAFB
DBEDC->FCAFDBEFDA
DCAAA->EBDEBEFEBE
CBADB->FDAFCDCBDA
FEDFA->CBDCAEABDB
EFDCF->ABEDAEDEBC
DEACC->FCDCEDBAFE
AAFCD->DCBCEADEFA
CCFEA->DEDEBEFAED
AABFE->DCBCFEABFA
DEAEF->AEFACFDCCB
CBAAA->DECDDCBCDC
DBDFC->EFCDCAEDEB
DDCAE->AEEFDEBCDF
ACFFB->EDBACAEDCF
BFEEB->CEABADFADA
FCCEA->BEDEAFDCBE
EBADF->ABAFCFCBDC
CFFFE->AFABACABAD
FADCE->ABFECADEAD
CCEFF->EBDEDBEDAB
BDFBF->EDEFCBAFAD
ABFEF->BCAFBEFADC
EEADF->DBFACFCBDC
BAFCE->ACFEABDEDB
FCBFA->CBBAECEDBC
DCBBD->FABAECAFEB
BEFDD->ACFABCEFAF
FECFB->CBDCFDEDCF
DCFCC->AEDEBCDEAF
DEDEB->FCDCFCDCAE
ADAEC->FBEFBCDCEB
DBCCE->AECDFDBAFC
FFFCF->CAEDCBBADC
EECFA->CBDCEFEDDC
EFBED->ABEDEDFACE
FBDEF->CACDAEFABE
BABAB->CEBCEDBCFE
FFBBD->ADABDECDBA
CBACD->FECDFBDEFA
FDDFA->BCEFAFABDC
EDAEB->BACBEDDCEC
CAEBB->DABCBACDED
FFBFA->CAEDCFEDBC
BCFEB->FADECBDCFE
FCBBE->BEDEEDCDBF
BACBA->DEBCAFCDBC
BFADE->DAEDDCEFCB
DBCDE->FCAFFECBDF
EBDAC->FCAFEAFEFE
CFFAE->DAABACBCBF
ACAEF->BCBABCDCCB
AFFDC->EDEDCBCBFD
BACFD->EDBCAFABEB
DEDAE->AEFAEBFEFA
CDCAE->FDCBFEBCAD
DCEAA->FCBABABCFB
CAFDB->FDFEBCEFDA
CDBDE->AFEFEDEFBA
CACEE->DFBCFEFADF
CACCE->DABCFDBAFC
ADFCE->BECBACBABA
FBDCE->ADAFEABADF
DCEBD->EBDEABAFBA
ECABE->ABBADBAFAD
CEFDB->DEFABCEFDA
CAEFC->EFBCADABEB
ECAAF->BFDEDCBCEA
CAEFE->FDFEABEDBF
FDAAF->ACEFBEFEAB
AEABC->DBDCBEAFFD
EFBDA->CBEDCFCBCD
DBBDC->EFCDFEEFDE
FEBFD->EAFACDABCE
FFEAA->DCEDABFECF
EDEFC->FCEFABEDAF
AEFBD->DBDCABAFEA
FFBEE->BEABAEDCBA
DDFAA->FCCBDCFEDC
FEAAE->CBDCDCBCAD
BADCE->CDBCFCBABA
CFFAC->DFEDBEBCBF
EEABC->BFDCBEAFFD
DFEDD->EFABBFEFEB
ADBFE->DBEFEDABDF
CBFEB->EFCDBEFAEC
CCCEC->DADEDFDCDA
AEBEE->DBDCECDCBA
CBAEC->FDAFCDFAEB
BBCFD->FECDFDEDFA
FDDDE->BCEFAFCBDF
DCCBD->EABAFDAFEB
BAABD->CEBCFBCDCA
CEFFF->BDFABCABCB
DCAFC->FABADBEDFD
AEFEA->DBDCABDCED
CCDDD->EFBACECBEB
BBEFF->ECAFBFEDAB
ABDCA->EFCDFCBADB
CDAFC->ABEFDCABFD
DCCED->EFDEAFDCFA
CDDFD->BFEFAEABAF
CFAEF->EBEDDCFADC
FDCEE->ABCBEBDCDF
CACFE->BDFEDFEDBF
FEAAE->CBDCDCBCAD
BECDF->EDFAEBCBDC
EDEAA->DFCBBFBCBE
BBEFA->CFAFABEDFB
BCFCC->ECBABEDEAF
CDFDE->FDCBCAEFBF
ACBBD->FBDEECAFEB
CCBEA->BDBACDFAFD
CCDAB->EBDECABCEC
DEECB->EFDCDFBACD
CBDBB->EBCDBACDCF
EAACE->FBBCFBDEAB
FCECD->CADEBFDEAE
DFDBA->AEABAFCDFB
FEEED->ABDCDFDCEF
CBFDD->BFCDABCBCE
FEACB->EAFACDBAEC
CFBCB->EFEDFEDECD
BECAA->CFDCDEBCED
EDAEF->DBEFDCFADC
EACCE->FCFEDFBADF
DBAEC->AECDBCDCEB
FFADB->DCEDBCCBDA
ECFBB->BFDEBCCDED
ADADC->BDCBEDCBDE
AFCED->CFABFDDCFA
BCDDC->EDBACECBDE
CFBFE->BDABDEABDF
EDEDD->ABCBDFCBEB
BBAFC->DACDDCABFD
DDFAF->CECBACBCBE
BFCAA->ECEDFDFEDC
AFFEF->CDABCBDCEA
FFFDD->CBEDBECBCE
EFACA->CBEDBCBABC
FEBAE->BCFAECFEAB
BCAEF->CDDEFBFABC
CABDE->DFBCEDEFBA
AFBAD->BCEDFEBCFA
AFCBB->DBEDFDAFED
DBEBC->EBCDABAFFE
BDFDE->ECEFCAEFBF
EFDED->BFEDAFDCAE
ADDCC->DCEFAFBAEB
AEAFE->FBFACDABDF
FCDAA->BCDECABCBE
BACFE->ACFEDFEDBF
BEFBD->ECDCABAFEA
AEEBB->DCFABACDED
AEDEF->DCFACEDCCB
CEFBE->DAFABCCDBF
DCDCD->EABAFCBACE
AFEAD->CFABDFFEFA
CDECC->EFCBDFBADA
DFACC->FAEDFBDEDF
BBFBE->ACAFABAFAB
DEFDA->EBFABCEFDB
ECCFC->BFDEDAABDE
EDCEA->DFCBDEFACD
FDBFB->CBCBECEDCF
FBCDC->CBAFEBCBEB
CBFAD->EFCDBEBCFC
FFCEA->DCEDFDDCBE
EBCFD->FACDBFABAF
DABBF->BAFEECAFBC
BCADC->ECBADCEFBD
EFABA->BAEDFBCDDC
AFCDB->CDABFDCBED
BFBDE->ECEDCFCBBF
EFEBA->FCABBFCDBC
AFFCE->CFABCBBABA
EADDD->BFBCFACBFC
CEDAE->FDDCFAFEAD
ABDCC->BDAFCEBADA
FCACB->CADEDCDEDA
FECAB->DCDCEFBCFE
ACEDD->CFDEDBEFAE
AADDE->BEFEFACBDF
EFBFC->FAEDFEABEF
DBFFC->FACDBEABEB
AEBEF->BEDCECDCAB
EDBEC->ADEFDADCEB
FFBDD->BEABAECBEF
AEADC->FBFACDCBEB
BCECA->EDBABABADB
DABEB->EBFEECDCEC
CCDBF->DEDECACDAB
FAEFA->DCFEABEDFB
DFCBD->EFABDECDCA
ECCBE->BFDEDACDFA
EFADC->BAEDFBEFFD
EFFDC->FAEDEAEFFD
FDAAB->ADEFCDBCFE
DEEFE->BADCBAEDBF
DBEDF->BACDABCBCB
EBCCB->BACDAFDECD
BAFBF->ECFEBCCDBE
DACBD->EBFEDFAFCE
FCDBC->BEDECACDEB
DAAFE->BAFEBEABBF
ACAAE->CFDEFBFEFA
CABAD->BFBCDABCAE
CABAE->AFBCECFEAB
AAECE->DCBCADDEDB
CCCBE->FDBAFECDBF
BFCEB->FAEDEBDCAE
AADBF->CDBCAECDCB
EFBEB->FAEDFEFACD
ECFFF->BFDEBCABCB
FCEDC->EADEABCBFD
ACCFC->DBDEDAABDE
FDFEE->BECBDCDCBA
ECFDB->DFBABCEFDA
DADBC->EBFEFACDAF
EEEBE->BFDCBACDBF
DEEEA->FCDCDFDCBD
DDDFE->BAEFEBABBF
EDEBD->BFEFBFCDAE
BDCAD->CECBDABCFA
FABBC->BEBCAEAFDA
DDFBA->CECBACAFBE
ACBEA->CDBAECDCBE
BBBCF->ECAFEDBADC
ADAFB->EDCBCDABFE
EAFAB->BABCBEBCAE
CDBEA->FECBECDCBE
AFBAF->CDABFEBCAB
DEECD->FADCADDECA
FDAED->BECBFDFAEB
EEABE->FADCEDAFBF
BBDFF->DACDCAEDAB
CEDBA->DAFAAECDBC
CBFDA->BDAFABCBFD
FFAFA->BEABFDEDBE
CFCCF->FEABFDBACA
DCAED->AEDEDCFACE
CEFAC->FDDCABFEAF
ECFAD->BABADCFEAE
ECEBB->ADDEDBCDCF
DFDFD->EAEDEBABEB
AEFFC->BEDCABEDBF
EFEFB->DFEDADABAE
AEDDE->DCFACECBBF
DAFCD->BCFECBBACE
AECDA->CDFAEBCBFD
DCADC->AEDEDCEFBD
ACEBB->CFDEDBCDCF
BCEDC->DEBABACBFD
AEBFE->CFDCAEEDBA
CBDDA->DECDCAEFDC
ACBFF->BCBACDABDC
CEECF->FDDCBABADC
DCBBD->FABAECAFEB
EEDFC->ADFAAFABDA
ADCDE->DCEFBDCBBA
FCEEE->BEDEDBFABF
CEAEB->DEFACDFAEC
EBEDD->BFCDABCBFC
DADEB->AFBCAEFAED
BDFBF->EDEFCBAFAD
BEBBE->EDFAECAFBF
BFFBA->CDABDCAFCD
BBCAE->CDCDBFBCFA
FFDBE->BCABFCAFDB
BDBCC->AECBEDBAEB
AADAD->DCBCAEBCFA
CCAEE->DADEBEDCBA
BCBFA->EDBAECEDBC
BCDFB->ECBAEBABDE
FBAFF->ABAFBCEDEA
DEDCF->EADCEBDEAB
ACACF->CDBADBDEBC
CBBCD->EFCDEDBACE
CBCED->FECDAFDCFA
BAECA->DABCADDEFB
CFDCF->BDABEBDEAB
AFDBE->FBABEBCDAB
EDCCC->FACBEBDEAF
DFBBA->CEABDECDFB
BFAAE->CDABFDFEBA
FEDBF->CADCFACDBE
EFEBC->BAEDBFCDFD
DDFAB->AEEFCAFECF
DDEDA->EBEFABCBED
CBFCE->FECDBEDEDB
AEBCD->BEDCECBAEB
FCCFE->ABDEAFABBF
DFFDF->EAEDCAEFCA
BAFEB->CEBCBEFAEC
DBACE->FACDFBDEAB
BCADA->DEBADBEFCD
BDBEB->DECBECDCEC
FACCB->EABCBFDECF
FDEDC->CBCBDFCBDE
BEEDA->ECDCBACBED
DFCAC->EFABDEBCBF
AEBDD->DBDCECEFEB
FEDEC->CADCFADCFD
CBDFE->BDAFEAEDFC
DEFBB->CEDCCBAFEC
AAFDC->BEFEABCBEB
EEAEE->FBFADCFABA
AFCCA->CDABFDBACD
DEABE->BADCBEAFAB
FDDFC->CAEFEBABDE
BAEAD->ACFEFAFEFA
BFAEC->FEABDBDCEF
ABAFA->EFCDBEABCD
AAAAF->BCFEFBFEAB
FDDAD->CAEFEBFEFA
FFBEC->CBEDEDFAEB
CEBCE->AFDCECBABF
CCAEA->FEBADBDCBE
CFDDD->BFABAFCBFC
CBEEF->DACDFADCCB
BEDBE->DADCFCAFDB
CAAAC->DFBCFBFEDF
FDABE->CBCBEDAFBF
ABDAE->DCCDBAFEFA
FCFBC->ADBABCCDAF
CDFAE->FECBCBFEBF
EDBDD->FCEFCFCBEB
BEEDD->EDFABACBFC
FABEE->BCBCFEFAFB
AEEAC->BDFADFFEDF
BCFAC->FEDEBCBCAF
ADDFE->BCCBCEABBF
EBECF->BACDBFDEBC
CECCA->EBDCEBDEFB
BDCDD->FEEFDECBCE
FDBDA->BCEFDACBFD
BEFDC->EDFADCEFDE
EFEFA->BAEDBFEDBE
CEEFD->BFFABFEDAF
DABFE->AFBCFEABFA
AEFAF->DCFADCFEBC
AECFF->BEDCEFEDEA
FBCAA->BCCDAFBCBE
FDCBD->EAEFFDAFEB
DFECB->EBABBFDECD
FCBEC->CADECDFABD
ACBCC->EDBADEBAEB
ADDAC->BDCBFCFEAF
DCCCC->AFBAEBDEAF
FBAAC->EACDDBFEDA
DBEDB->CEAFABCBEC
AFEEE->BCEDADFACB
AEFDF->DBDCABCBDC
DCBEA->CEBACDFAFD
EDEBD->BFEFBFCDAE
BBEAB->CFAFABFEAC
BFEEA->DEABDFDCBD
CFAAA->BDABCDBCDC
BBEFA->CFAFABEDFB
BFACE->ECEDBCBAFB
BEFCF->CFDCCADEBC
CABFF->BDFEECEDCB
AECFF->BEDCEFEDEA
BDDEE->EDEFCEDCDF
BCFFA->CFBABCABED
DAFDF->CEFEABCBDC
CCBDF->BDBACDEFBC
FADDB->EABCFCCBDA
FDBCC->ADEFEDBAEB
AFCFA->BEABDEABFD
FCDDF->CADEAEEFCA
FBEDB->EACDFACBDA
BCAAB->CDDEFBFEEC
AAFDB->DBFEBCEFDA
BADAE->ACFEFAFEAD
CEFEF->EBDCCBDCEA
DEAFF->EADCFBABAC
CBDDE->FDAFEBEFAB
ABBDF->CFCDFEEFCA
CCCFD->BFDEFDEDFA
CECEB->EFDCFDDCEC
EFDDA->DFEDFCCBFD
FCABA->CADEDCCDFB
DAFBB->EFBCCBAFEC
AAFFE->BEFEABEDAD
DCAEE->CADEBCDCDF
DAAAD->AEBCBEFEFA
BBEBD->FECDABAFBA
FCCDA->CADEDAEFBC
CDCBA->DAEFFDAFCD
DAEAE->FCFEADBCDF
CFDDC->FDEDFACBFD
ECFAE->ABBADCFEAB
DCDFF->CEBAAEABAD
EFBEE->FBABEDFABA
BDBFD->CECBCFEDFA
EDEAD->FCEFABFEBA
FDFEC->CBCBCBDCFD
BBEED->CEAFBADCAE
BFCCD->CFEDFDBAEF
BACBD->CFFEDFAFCE
AADDF->BCFECAEFBE
BDCFF->CDEFFDEDCB
DAAFB->FCFEFBABDE
AFAED->DCABEDDCFA
DFBAA->FCEDFEBCBE
DDBBB->EBEFCFAFCF
DAAEE->AFBCDCFABA
AEEBF->BEDCBACDBE
EBDCF->CBAFEABACB
EBCFF->ABAFFEABCB
DDCAC->FACBFDFEDA
FCCDA->CADEDAEFBC
BDCAC->DECBFDFEDA
BECCF->ACFADADEAB
DBECF->AFCDBFDEBC
ADEBF->BCCBBACDBE
FFABE->ADABCDCDBF
EEDFD->BFDCFAEDAE
BECCE->EDFAEBDEDB
EBABC->BACDFBCDBF
FEFBA->CBDCEACDDB
CBDBD->BFCDFCAFBA
DCEBD->EBDEABAFBA
CAFAF->DABCABFEBE
CDAFF->FDCBCFABCB
CCBDA->EBDEEDEFBE
ECDFE->CDBAEBABBF
FEADD->BEFAEDCBEB
EAEEC->ADBCDFDCDE
AEDED->BEDCFADCAE
EFBEF->BFEDECDCAB
CDCBB->DECBEBCDED
BBCCD->CEAFEBDECA
CADEC->EFBCAEFADE
DCAAA->EBDEBEFEBE
ECFBF->ABBADCAFBC
EAADF->ADBCEDCBAC
AEFAB->CFDCCBFEAC
CFCEA->DEABEBDCED
AEBAF->CFDCAEFECB
DDEFC->EBEFABEDAF
FFAEB->ADABCDFAEC
EDAFB->FACBFDEDEC
FBEFD->EACDFAEDFC
BCDAD->CFBAAEBCFA
AEDFA->EFFAEBABCD
ADCCE->FBEFFDBAFC
CBCDA->DACDEFCBED
ACFAC->EDBACAFEFD
DFBBD->EBABDECDBA
BEDEF->EDFACEDCCB
BBCAF->EDCDAFBCAB
EEACC->ADFAFDBADE
DADFD->FAFECAEDAF
EABFE->CDFECFEDAB
FEDAE->CADCFAFEAD
BBBBF->CFAFCFAFAB
FBDFC->ABAFEAEDFE
ACCAA->EFDEFDFEDC
DDEBC->FCCBBACDAF
ADDDD->DCEFAFCBFC
CFFCB->DEABDCBACD
EBBCA->FCAFCFBABC
ACCFE->BCBADAABBF
ECFAF->ADDEBEBCCB
FEBBA->BEFAECAFCD
BDFCC->DACBDCBADA
DEEED->EFDCDFDCEF
CAABF->DABCBEAFAB
BCCAB->DEBAEBFEED
AEBFB->EDDCECEDCF
DCEDE->AEDEBFEFBF
DEEBE->AEFABFCDAB
AEECA->BEDCBABADB
CFCFB->DEABEBEDFE
BECCF->ACFADADEAB
FFEBA->ECEDBACDFB
CFDEB->EFEDFCDCAE
AACBD->BEFEDFAFCE
CBBFB->EBCDEDABFE
BEDEA->DEDCFCDCED
BAAFC->ECFEDCABFD
FCDDD->EADEFACBFC
BAEFC->DEBCADABEB
CBBBD->EBCDEDCDBA
DCFEC->FABADCDCEF
BFEFB->DEABDFEDFE
CDCED->BFEFDAFAAE
BAACB->CDBCEDBADE
EACDA->CBFEDAEFBC
BDDAB->DECBFCFEED
FCCCB->DCBADADEEC
BBEDC->DACDADEFBD
CCFBC->DADEABAFFD
EFACE->BFEDBEBAFB
AEDBD->FBFAAECDAE
AAFCF->CFBCCBBADC
CDCEE->AFEFDEFAFB
FCDAF->DEBAEBFEAB
BEFAB->CEDCEABCAE
FBCDD->EACDEFCBFC
DAAEE->AFBCDCFABA
BEDBB->CDFAAFCDED
EEFDC->BADCEAEFFD
AFAEB->FDEDBEDCEC
FACBA->BCBCAFCDBC
ECCBC->DFBADACDEF
AFAEB->FDEDBEDCEC
AFCBA->BDABDACDDB
CAFBC->ABFECBAFEB
BFFAA->EDABCBFECF
CBBCF->FDAFEDBADC
ACCEA->BDBAFDDCBE
CDEAA->BDCBBABCFB
AABCD->CFBCAEBAEB
EADBA->FBBCEBCDBC
FBFBD->CBAFADAFEA
DFADC->AFABDCEFBD
AEDCF->CFDCFCBADC
DFFAE->CAEDABFEAD
ADBEE->BECBCDFACB
ABCDE->CFCDBFEFAD
FDFDB->CBCBCBCBEC
EAABA->CBFEDCCDFB
EAECF->ABFEBFDEBC
BFCFF->ECEDFDEDCB
DEFEB->EBFABCFAEC
ACDFA->BDBAFCEDDC
AFAFA->BDABDCABED
DDBAB->EFCBDABCFE
FDFBF->DECBCACDCB
DEECC->AFDCADDEAF
CDBDF->FECBECEFCA
DADBE->AFBCAECDAB
BDABD->FEEFCDCDBA
DFBDA->EFABDECBED
BEDAF->CFDCEFBCCB
EBBBF->DBCDCFAFAB
EACBD->FCFEDFAFCE
FBABC->CBAFBEAFFD
FEFFE->CBDCEAABBF
FBBBF->ADAFCFAFAB
AAFAA->BCFEBEBCED
DACAE->AFBCAFBCBA
FBEBF->BCCDBFCDCB
FCCBD->BEDEAFCDAE
DBADE->AFCDFBEFAB
EAECD->FAFEFADECA
ABFBE->FBCDEACDFA
CCABD->FEBADBAFAE
AFDBE->FBABEBCDAB
DCDCD->EABAFCBACE
FDEFC->ADEFBFEDEB
CDCFE->DAEFFDEDAB
BBEFF->ECAFBFEDAB
EDEFD->FACBBAEDAE
AAAAC->BDBCFBFEDF
FEABF->DEDCFBCDEA
DBCBD->AECDFDAFEB
EACFE->ABFEFEABDF
CFADB->DEABFDEFED
CBDBC->FDAFEBCDFD
AFCCE->BCEDBFDEAD
BDADF->CDEFBCCBDC
FDFEC->CBCBCBDCFD
DBABC->AFCDFBCDBF
CFEDF->BDABBFEFCA
EFEBE->FBABADCDAD
AFFEC->BEABACFAFD
CEBDC->DFDCEDEFEB
EEBED->ADFADADCFC
DADBC->EBFEFACDAF
AACEE->CFBCBFFABF
EDDDC->FACBCECBDE
BFCAC->FEABEFBCAF
BEEBF->CFDCFCAFAB
EDAFD->ABCBEDEDFA
FFDCB->CAEDFABAEC
FFCEA->DCEDFDDCBE
BBCFC->AEAFDAABDE
FCACA->BEDEFBDEBE
CBDFC->DECDCAEDEB
ECAAC->BABADBFEDA
DDDAD->AEEFEBFEFA
BAFBC->EDBCEACDEF
BCAEB->DEBADBDCEC
EFEFF->CBEDABEDBE
BCCFC->ECBADEABEB
FBFDA->BCCDBECBFD
DDBCA->FCCBDADEFB
FBEAC->ABAFABFEFE
AEEEB->DBDCBADCFE
BEBCE->CDFADADEDB
DDDFA->CECBEBABCD
DADFD->FAFECAEDAF
EBEEE->BFCDABDCAD
ECFAB->FCDEBCBCFE
BFDEE->CFEDFADCAD
EBDCA->BACDBADEDC
EDEAE->FACBBABCBF
EFFBE->BFEDABAFAB
CFFAE->DAABACBCBF
BDCEF->EDEFEBDCCB
DAFBB->EFBCCBAFEC
CDCFF->DECBEBEDEA
AACAC->BEFEDFBCFE
CECEB->EFDCFDDCEC
FEBAE->BCFAECFEAB
FFCCE->ABEDBFDEAD
FEFBB->EAFABCCDED
BAFBF->ECFEBCCDBE
EEAEE->FBFADCFABA
CEBEF->DAFACDFAEC
EEACA->BADCDCDEDB
EBCFB->BFCDFDEDCF
DFBFA->AEABECEDBC
BDDBE->ECEFEBCDAB
DAFCD->BCFECBBACE
BAEDA->DEBCADEFDB
BFADC->EDABEDCBDE
DBADA->FCAFCFCBFD
BFFFF->EDABCBEDBE
AFAAC->DBEDBCFEAF
ADADB->CDCBFDEFED
ADEED->DCEFCBDCFA
FDBBD->CBCBECAFEB
ACAFA->BCBABCEDDC
BDCDE->EDEFEBCBBA
DFCFC->AFABDAABDE
FBEBF->BCCDBFCDCB
FBBDD->CBAFECEFEB
ACDDF->DBDEAEEFCA
BDBCE->EDEFECBABF
EFCFA->FCABDEABFD
ADFAB->DBEFCAFECF
CBEBD->AFCDABAFBA
CBCEC->DECDBFFADE
EDEBD->BFEFBFCDAE
ADBBB->FDEFEDCDED
FCDDD->EADEFACBFC
CCDFA->EBDECAEDBE
BACEC->EDBCAFDCEF
BFCFA->CFEDFDEDBC
EEABC->BFDCBEAFFD
EBEED->ADCDADFAAF
ABCED->DCCDAFDCFA
FCEEA->ECDEBFDCBE
EFEBE->FBABADCDAD
BDFBB->CECBEACDCE
CCBCD->FEBAECBAEB
BFDCD->FEABAFBACE
FCEFD->CBBABAEDAE
EBFCF->ABAFBEDEBE
FFADF->CAEDBCCBDC
BACFD->EDBCAFABEB
CECCE->FEFAFDBAFC
DBCDD->FACDAFEFEB
EAFFD->BFBCABEDFC
BDFBA->DECBCBAFBE
FBFBE->BCCDBECDAD
FAADA->CAFEBCCBFD
DBDCE->CACDFCBABA
DEEEA->FCDCDFDCBD
CFEFA->FEABDFEDDC
FAFFE->ADFEABEDAD
EEBED->ADFADADCFC
CDFBB->EBCBDCAFED
DFBAE->AFABEDBCAD
FCADF->DEBADCEFDC
FBEFB->DCAFBFEDEC
DAFDA->FCFEBECBFD
FFDBC->ABEDFCAFFE
CCCFE->AFDEDAABBF
AADBA->BDBCEBCDBC
ACBDD->BCBACDEFEA
CEBDF->DEFACDEFBC
AFCEB->DCABFDDCEC
BEBFF->ECDCECEDCB
BFBFC->FEABECEDFD
FFFDA->CAEDCBCBED
DFFDE->FAEDBECBBA
BEADC->DEDCEDCBDE
AEEDD->DCFABACBFC
DCCCE->FCBAEBDEDB
EABED->BABCEDFACE
FEFFD->ABDCCBEDAE
FEACA->CBDCDCDEDB
DEABF->AFDCDCCDBE
BAEAE->DABCADBCDF
EADAC->FAFEFAFEAF
BDBEF->CDEFCFDCCA
DEACD->AEFACFDECA
BDCBE->DACBEBCDBF
ADCEB->CFCBEBDCAE
EFEAD->ADABBABCEB
EBAEB->ADCDDCFAEC
FFADF->CAEDBCCBDC
CFEDB->FDEDABCBEC
FEFCF->ADFABCDEBE
FCDCB->CBBACEBACD
FAAEB->CAFEBCDCAE
EFFFC->BFEDABEDBF
EFCBF->ABEDAFCDCB
FBCCD->BECDBFDEFC
DBBBB->AFCDEDCDED
CDFFC->DECBDCEDFD
CCFFD->EFBADCEDFA
AEBDE->BEDCECEFBF
DDDFB->FCCBCEABDE
CBEAC->DECDADBCBF
BFEAB->FAEDBABCED
EBDDB->BACDBAEFED
ADECA->BCCBBABADB
EAAEB->BFBCBEDCEC
BCAFC->DEBADBEDFD
CCCCA->DADEDFBABE
FEEDE->BCFABACBDF
EDBBC->FACBDACDBF
EBFCD->FACDEADEFA
BDFCF->CDEFBCDEBE
AAABC->FBFEBEAFFD
EABEF->ADBCAEDCAB
ECAEF->CBDEDCFADC
EEAEF->BFDCBEDCAB
EBDDE->BFCDAEEFBF
CDDEB->FDCBEFDCAE
DCAAC->AFBADBFEDA
CAFBA->DABCABAFBC
EBFDE->FACDEAEFAB
EFDAC->BAEDAEBCFD
EAECB->BFBCBABAEC
DACBF->AFBCAFCDCB
CFEDF->BDABBFEFCA
CDACF->FECBEDBACA
BDFFF->DACBDCEDCB
FAEBD->CBFEBFCDAE
FFCDE->ADABDECBBA
CEABD->BFFACFCDCA
EADED->ADBCFCDCFC
CDBFE->FDCBEDABDF
DAECC->EBFEFADEAF
ABFEC->BDAFADFADA
ECCAF->CBDEDABCAB
ECDCE->BFDEAEDEBF
DBEFF->AECDABEDBE
AFCCB->CFABFDBADE
CBFEC->DFAFADFADA
ADBAD->FBEFCFFEFA
EBDCD->BFCDAEDEAE
DEEFC->AEFABFEDEB
DABED->BCFECFDCEF
DACEE->FCFEAFDCBA
BBDCE->CFAFEABADF
AEFDA->BEDCABCBFD
DECBF->EADCDACDAD
EBBBD->ADCDFECDAE
EBCCB->BACDAFDECD
CBFBC->DECDEACDEF
EEFFF->ABDCEAABAC
BDCFB->DECBFDEDCF
CDDBC->EFCBFCAFFE
BDACD->CFCBCDBACE
BFFEE->EDABCBDCAD
BAECA->DABCADDEFB
BBDCF->CDCDCADECB
CACEE->DFBCFEFADF
ABBBC->FBCDFECDFD
CFDBA->FDEDFACDFB
FEFBF->ABDCCBAFAD
ECACC->FCDEDCDEBD
AFDEB->CDABFCDCAE
ABEDA->EFCDBACBED
FAAAE->ADFEBEFEFA
EAAEA->FBBCFBFACD
AEFBB->CDFADCAFED
DABFD->EFBCAEEDAF
AEEEC->BEDCBADCFD
CFFAB->EFEDEABCAE
BFFDE->ACABACEFBA
CBDBE->AFCDAECDAB
EEEFC->BFDCBAEDAF
ECFAE->ABBADCFEAB
EABDA->FCFEECEFCD
DADEB->AFBCAEFAED
ADCEA->CDCBEBDCED
DEBCB->FCDCAEBAED
CCCEF->BDBADAFABC
CFEBF->FDEDABAFBE
CECDC->FDDCEFCBFD
DDCBF->AEEFDECDEA
ECDBA->BABACEAFBC
FCFCB->ACBADCBACD
DADAC->EFBCFCFEAF
AEDFF->BCDCFCEDEA
CBADA->EBCDFBEFBC
CDCCF->EBCBEBDEBE
ECFBE->CDBABECDAD
ACAFC->FBDEBEABDE
DEBAA->AEFAEDBCDC
EEBDB->DFDCDECBEC
ADBFD->CFCBDAEDFC
AFBBA->CDABFECDBC
FFCBF->BCABFDAFBC
DFBFB->EBABDEABFE
AAFBA->BEFEABAFBC
DEBAD->BCFAEDBCAE
EDAFD->ABCBEDEDFA
EBDDE->BFCDAEEFBF
FFEBC->CBEDBFCDFD
CEDEC->FDDCFADCFD
BEACA->EDFAEDBACD
CCCBF->DADEDFAFAD
AADFF->DBFEAEABAD
BDCCB->CFCBDEDEED
BBBEA->DACDFEFACD
DACDC->FAFEAFEFDE
DDCEF->AFCBFDDCAB
ACEBE->BCBAFBCDBF
ACFFD->FBDEABEDFC
CBCAD->BFCDEBFECA
BAFED->CFFEABDCFC
FAFAA->DCFEBCBCDC
EDDFA->DFCBEBABCD
CEFCE->FDDCABDEDB
CEFAC->FDDCABFEAF
EADFA->FCFEFAEDFB
AEDCC->EDDCFABAEB
CBABC->ABAFBEAFFD
CFAAF->FEABEDFEBC
AFFBC->FBABACAFEB
BBFFA->CDCDEAABCD
BBFFF->CFAFABEDEA
DDDCB->EFCBCEBACD
FCCAC->BEDEAFBCFD
BEDDB->ECDCFACBEC
AACEF->DBFEDAFABC
EFCBB->BFEDEBCDED
ACEDF->BEBAFBEFCB
BCBDF->ACDEEDEFCB
DBBAB->CEAFCFFEEC
EDAAF->ADEFDBFEBC
BBAFA->EDCDFBABCD
EBBAB->DFAFCFFEEC
CEFFF->BDFABCABCB
DECBF->EADCDACDAD
CFDBA->FDEDFACDFB
DCDBD->AEDEAECDAE
BEBDF->CDFADACBDC
ADDAC->BDCBFCFEAF
DFDEF->BAEDFADCEA
ACCAB->CDBAEBFEED
DCFDC->FCBADCEFDE
FADAA->CAFEFCFEFB
DCBBD->FABAECAFEB
CDDCD->EFCBFCBACE
CCAAB->DEDEFBFEEC
CFFDB->DAABACEFEC
CDFCE->DAEFBCDEDB
DBEFD->FACDBFEDAF
ECFFF->BFDEBCABCB
FFEBE->BEABBACDBF
BAFCB->CFFEABDEED
CEFDE->DFDCBECBBA
ABDDF->BEAFEACBEA
CADAC->DEBCFCFEAF
DFADD->FAEDFBEFEA
DCDEE->FABACEDCDF
BAFFF->CDBCCBEDBE
BEADE->ECDCBECBBF
CFCEE->FDEDFDDCBA
FFEFE->ADABBFEDBA
FCABD->CBBADBAFAE
CDDBD->EBCBCEAFEA
FABFB->CAFECFEDCF
AECAE->CFDCEBFEAD
DADCB->FCFECADECF
BEDEE->CDFAAFDCAD
FECCF->BCFAEBDEBE
EBBDA->BFCDCFCBCD
DFFEA->FCEDEAFACD
CFCEC->EFEDBFFADE
EBBEA->FBCDEDFAED
BADCF->EDBCAEDEBC
AEBCF->DCFAECBABE
EEBFB->FADCAEEDEC
FBDEE->BECDCAFABF
ACCBA->BCBADACDDB
FBEEA->DCAFBFDCBE
BBFDE->CDCDEAEFAB
DAEFF->EBFEFAEDEA
DDCDD->EFCBEBCBCE
DAAFA->CEFEBEABCD
CEABB->EBDCEDAFED
AABCE->DBFECDDEDB
FDBEF->ABCBDADCCB
FFFCC->CBEDBEDEAF
DFDDA->CEABEBEFBC
AAFBC->DCBCEACDEF
DFFBB->AFABEACDCE
BDABB->ECEFCDCDED
FABCB->CBFEACDEED
EDFBE->FACBDCAFBF
DDEEE->FACBDFDCFC
DEEBD->EADCBFCDAE
FDEAF->DECBFCFEAB
ABCAE->BCAFFEBCAD
CACFC->DEBCBFABEF
FAEAF->CAFEBABCBE
FDDBD->BECBCEAFEA
EDAAB->FCEFBCFEED
BAAAC->DABCDCBCAF
DECBB->EBFADACDCE
DEACD->AEFACFDECA
FCACF->BCDEFBDEAB
CBABF->FDAFCDCDBE
BFDCC->AEEDAFBAEB
FEDAD->BEFACEFEFA
DBAEE->BACDBCDCDF
BABCB->FABCEDBAEC
EBDDB->BACDBAEFED
EECED->BFDCEFDCAE
CCEFF->EBDEDBEDAB
DECBE->FADCFDAFBF
AEABC->DBDCBEAFFD
EACCE->FCFEDFBADF
CDBBC->DECBDACDBF
EDEDA->FCEFABCBED
ACFBE->DCDEADAFAB
FABDD->EABCAECBEF
ABFBE->FBCDEACDFA
DFBBB->FCEDFECDCF
EFFCE->FBABEADEAB
ADCAB->DCEFBDFEEC
FBBED->ABAFCFDCEF
FFBAE->CBEDEDBCAD
FFFAC->BEABDCFEDA
CEFFD->AFDCABEDFC
EBAAA->CBAFBCFEFB
EEBAA->BFDCECFEDC
BBFBF->DACDEACDAD
BADBD->FEBCFACDBA
DFCFE->FCEDBFABFA
BDDFF->EDEFCEABAC
EFEDC->FCABBFEFDE
FDACA->BCEFDBDEDC
DDEEB->EBEFABDCFE
BABFF->ACFEECEDCB
ABFBF->CFCDEACDAD
FAEEC->BEBCDFDCDE
AFEDC->BEABBFEFDE
FCDFA->BEDECAEDBE
ADECA->BCCBBABADB
EFBBB->ADABAEAFCD
FECAD->EAFADABCFA
ACEDA->BCBAFBEFBE
AFCCB->CFABFDBADE
FAEEB->EABCDFDCDE
CCCCE->DFBAFDBAFC
DEACB->CEDCEDBADE
AACBA->CDBCAFCDBC
DACFD->BCFEFDEDFA
DCDDE->FCBACECBBF
EDFCE->FCEFBCDEDB
FFBFB->ADABDEABFE
BFABD->ECEDBCAFBA
DABEA->AEBCECDCBE
CADAD->FEBCAEBCFA
BDEDB->CDEFABCBEC
AAEFD->CFBCDFEDFC
BDEBC->DACBBACDAF
EFFED->FAEDEAFAAE
EADCF->BABCEBDEAB
BEEBA->CDFACBAFBC
FFCDD->CAEDFDCBEF
BBBBE->ECAFEDCDBF
AFEDC->BEABBFEFDE
DCEEF->AEDEBFDCAB
AACCA->EFBCEBDEFB
CFFDD->FEABCBCBFC
FCFBE->CBBADCAFBF
DCAFD->EABABEABEB
CEEEA->EBDCDFDCBD
FBCDA->ECAFDAEFBC
EBFDA->DFAFABCBFD
FEDCE->BCFACEBAFB
CAEEB->EFBCADFADA
ECECD->BFDEBFDEAE
FDADF->ABCBFDEFCA
BECEC->DADCEBDCEB
BEDAC->DEDCFCFEAF
ECEBB->ADDEDBCDCF
EBBFA->DFAFCFEDBC
AABBB->CDBCFECDCF
ACAFF->BEBABCEDEA
CEEFA->BDFAFBABDC
DEBFC->AFDCFEABEF
DACDE->AEBCFDCBFC
EACDF->DBFEFDCBCA
DEFFA->FCDCCBEDFB
FFEEE->ABEDADFACB
DDDAC->FCCBCEFEDF
AECFB->DCFAEBEDFE
EADEF->DBFEFCDCCB
ACCAA->EFDEFDFEDC
BCDBF->CDDECACDAB
DCEAB->AEDEBFBCEC
EDABB->BFEFCDCDED
ADCBA->BECBDECDDC
AECEC->BDFAFDDCEF
ACBCE->FBDEECBABF
BBDEF->ECAFEBFABC
AEDDA->BDFAFCCBFD
ECADC->BFDEDCEFBD
ACACD->BCBABCBAAE
CDACE->AFEFCDBABA
BDACE->CDEFBCBAFB
FCCDA->CADEDAEFBC
ADFFB->FDEFCAEDCF
BFDDB->CEABAEEFED
ACEBE->BCBAFBCDBF
CDBDE->AFEFEDEFBA
AFCDF->BCEDBFEFBE
CFACD->EBEDDCDEAF
CCCCA->DADEDFBABE
EFDED->BFEDAFDCAE
BCEAE->EDBABABCBF
ABDFA->DBAFAEABDB
FACEB->DCFEDAFACD
EEBBF->ABDCFECDCB
BECFF->CFDCDEABDC
FFCCB->ACABDADEEC
EFAAD->FCABCDBCAE
CEDDE->FEFAFCCBBA
ABDEA->BEAFEADCFB
FEFCA->DCDCABDEFB
BCCDC->FEDEDAEFFD
EACAC->FCFEDFBCFE
FBDEE->BECDCAFABF
BBCCC->DECDAFDEDA
AFEFD->DBEDABEDAE
ECCBE->BFDEDACDFA
BFBCB->DEABFEDECD
DAFDA->FCFEBECBFD
CCABA->FDBACDCDFB
CEBAC->DEFACDBCBF
DBAFF->BACDBCEDEA
BEDEE->CDFAAFDCAD
FDBFD->BECBDAEDFC
ECDBE->FCDEAECDAB
EECDA->DFDCDECBFD
DEECB->EFDCDFBACD
CCFFD->EFBADCEDFA
FEDCD->CBDCAEDEAE
BEDDA->DADCFCCBFD
ECBCA->BFDECDDEFB
FECDE->ABDCEBCBBA
CBCBD->FDAFDECDCA
CCCAA->FEBAEBFEFB
DBBDD->BCAFCDEFEA
CABEE->BDFEECDCBA
ABADC->BEAFBCCBEB
FFCCD->ADABDEDECA
FAEBA->CAFEBACDFB
FFCDB->EAABDECBDA
CCDFB->FDBAEFABDE
CBABD->EFCDFBCDCA
BFFCC->EDABCBBAEB
AEAFC->EDDCBEABDE
FABBD->CAFECFAFEA
EFCFE->FBABDAABBF
ADFAF->CDCBDCFEBC
AAFBD->FBFEABAFEA
BCADD->CFBABCCBCE
ECAAE->FBDEDBFEAB
FBBEA->BECDFEFACD
ABFCD->BCAFBEDECA
BDCAA->CDEFFDFEDC
DEEEA->FCDCDFDCBD
AAEDE->BCFEADEFCB
DFBAD->EFABDEBCAE
BAFEF->EDBCEAFABC
DDBEB->CECBCDFADA
DBBAE->CACDECFEAB
DFBDC->FAEDEDEFEB
AECDE->BCDCEBCBBA
ACCEB->DBDEDAFACD
AEFCA->BCDCCBBADB
DBACD->BCAFDCDEAF
DEDAB->AFDCAEBCEC
EECAB->FADCEBFEED
FDCED->ADEFDEFAAE
CDEAE->AFEFBFBCBA
CDFFC->DECBDCEDFD
ECCAB->DFBADABCEC
ABCFA->BDAFEBEDDC
EDDCA->FCEFEABABE
EECFC->DFDCDEABEB
EFAFA->FBABDCABED
BFDFE->ECEDFAEDBF
BFBBB->CEABEDCDED
FCEDC->EADEABCBFD
ECEEF->BFDEBFDCAB
DADCC->AEBCFABAEB
AABDB->EDFECDEFCF
BABCB->FABCEDBAEC
FDAFC->CBCBEDEDFD
BCCEB->ECBADEFACD
CEEDF->EBDCDFCBAC
DFBEB->EFABDEDCAE
FFACF->ADABCDBADC
DCCBC->FABAEBCDAF
ADDCF->DBEFEBDEAB
FDDDB->ADEFEBEFCF
EECDA->DFDCDECBFD
ABAAB->DCCDFBFEEC
DDCEF->AFCBFDDCAB
EEDFA->BADCAEABDB
EFFDA->BFEDABCBFD
FADFC->CBFEBAEDFD
CDABF->BDCBFDAFCB
CFCBC->DAABDECDBF
BDCFE->CFCBDEABBA
DCADE->BADEDCEFCB
DFDCF->CEABEBDEAB
FAEFD->BEBCDFEDFC
AFCAC->EDEDFDFEDA
CECBD->FEFAFDAFEB
FDBFA->DCEFEDABED
BEEBE->ECDCBACDBF
CCBBF->FDBADECDBE
CFFEE->FEABCBDCAD
CBBBE->FDAFEDCDBF
CCECF->DEDEDBDECB
ECEAB->BFDEBFBCEC
CABBF->DEBCAEAFCB
DDFFB->EBEFBCABFE
DEBAA->AEFAEDBCDC
DABEE->FAFEEDFABA
DADEA->EFBCFCDCED
FBDBD->ADAFEAAFCE
FAEED->CAFEBADCAE
FBCDE->BECDBFEFAD
CEFBB->EFDCEACDCE
CBCAD->BFCDEBFECA
ECBDE->CDBAEDEFBA
CFDAF->FDEDFAFEBE
CEFFF->BDFABCABCB
FAEAC->CBFEBFBCFD
CBACD->FECDFBDEFA
BAFEC->ECFEBCFAEB
DFADD->FAEDFBEFEA
DABAB->FCFEEDBCFE
AFBCD->DBEDCFBAAE
EEAAC->FCFACDBCAF
FBECF->DEAFADDEBE
FEECD->EAFAFBDEAF
BEDBC->EDFACEAFFD
BDEED->EDEFBADCAE
FDBDD->ADEFEDEFCE
AFADB->EDEDBCCBDA
DDEBA->AFCBDFAFBC
BCABE->ACDEFBCDAD
CAFDE->FEBCEAEFAB
AAFED->BEFEABDCFC
DDBEA->AFCBECDCBE
ADDAA->EFEFAEBCBE
FECFC->EAFADAABDE
CDCED->BFEFDAFAAE
DBFDA->CEAFABCBFD
CDAFD->EFCBEDEDFA
ABFCC->BEAFABDEAF
EADBC->FCFEFACDAF
FEECE->BEFABABABA
BDFAA->DACBDCFEDC
CACBC->FDFEDACDEF
CEDAD->EBDCFCFECA
ACDEF->CFDECAFABE
EBDDC->DFAFEACBDA
CAEEF->DEBCDFDCCA
CDEDB->DECBBACBEC
EEBCF->BADCFEDEBC
DFBBD->EBABDECDBA
FABAB->ACBCEDBCFE
DDCBF->AEEFDECDEA
FCCEF->BCDEAFDCAB
BFFAD->ECEDCBFEBA
FEEBB->CBDCADCDFE
ECDEF->ADDECAFABE
DBEAD->BCAFADBCFC
CDAEC->EFCBEDDCEF
ECFBE->CDBABECDAD
FCEFB->ADBAFBABED
DCBBA->EBDEECAFCD
CCBDB->FDBADECBEC
CBDAB->FDAFEBFEEC
FADAE->BCBCAEBCBA
CCDBE->DADEFACDBF
CBCAE->AFCDFDFEAB
FDDAC->BECBCEFEDF
EEAFF->ADFAFDEDAB
DFAED->BCEDBEDCFA
DFFDC->EFABACEFEB
EEAED->ABDCDCFACE
FFCAC->ABEDBFBCEB
AEFED->DCFADCDCFA
AAADC->EDFEDCEFBD
CFADE->DFEDFBEFAB
BDEDD->ACEFABCBFC
DCDCE->AEDEAEDEBF
BBCDD->ACAFFDCBEF
CDEDD->EFCBDFCBEB
BBACC->FECDBCBADA
EBFBB->FCAFABAFCF
DDAEA->EFCBFDFACF
DADED->EAFEBADCFA
AADED->CFBCFCDCFC
ECFBD->FADEBECDCA
CEEFF->FEFADFEDEA
CDDDA->FDCBEFCBFD
EAEEF->CBFEABDCEA
ABCEF->CFCDBFFABE
FCEAB->CADEBFBCEC
BFFDF->DAEDEAEFBC
ABABD->FBCDDCCDBA
CEEEC->DAFAFBFAFD
CAEDF->FEBCADEFDC
EABEB->FCFEECDCEC
ADCBD->FBEFFDAFEB
CEEAB->EFDCADBCAE
CDEEC->DECBBADCFD
BBACB->CFAFBCBACD
DADED->EAFEBADCFA
EEAEA->FCFACDFAED
AAADF->CFBCEDCBAC
CFCCD->BFABEFBACE
DFCBE->AFABDACDFA
BFFEB->ECEDCBDCFE
AFABA->EFABDCCDFB
CCDEB->DADEFADCFE
EFFBD->ADABDCAFEB
DEDFB->CEDCFCEDFE
BEBEC->DEDCAEDCEF
DDAFF->AEEFCDABCB
BADAB->CFFEFAFEED
AADAE->FBFEFAFEAD
BCCEC->AEBADEFADA
FDDEB->CAEFEBFACD
EBFEC->ADCDEAFADA
ACDAD->BEBAAEBCFA
EFCEF->DBEDEBDCCB
AFEEA->CDABDFDCBD
BEEAA->EDFABABCFB
CDEAB->EBCBBABCED
FCACE->CBBADBDEBF
ACDFF->CDBACEABAC
BACED->ACFEDFDCEB
AACAE->DCBCAFBCBA
CEEDF->EBDCDFCBAC
ADAED->CFCBFDFAEB
DCDBA->AFBACEAFBC
EFBCD->BFEDECBAEB
BBFEB->DECDBEFAEC
CEFCF->DAFABCDEBE
ECDEB->FCDEAEFAED
AEAAA->BDFADCBCDC
BBCAC->ECAFDEBCBF
AADBD->BCFECACDFC
CFEBE->DFEDBFCDAB
CFACD->EBEDDCDEAF
ABCCF->BEAFFDBACA
BECFA->CDFABDABCD
BEFFB->ECDCABEDFE
FBADC->ADAFBCCBEB
FEDEE->ABDCFCDCDF
DCEAB->AEDEBFBCEC
DDCCA->AEEFDEDEFB
EEEBA->CBDCBACDFB
BEBEB->FAFAEDFAEC
BFBBA->DEABFECDBC
FAFFB->EABCCBEDED
EDFAF->ABCBCBFECA
FEAEC->CBDCDCFAEB
EFDAC->BAEDAEBCFD
DCBDF->CEBACDEFBC
DEAAF->CEDCEDFEBC
CBBEC->DACDCEDCFD
FDEEB->ADEFBFDCEC
BCEAC->AEBABFBCFD
ACBEA->CDBAECDCBE
BFAAF->EDABEDFEBC
EACBC->BFBCFDAFDE
ADCED->BECBDEFAAE
EBDAC->FCAFEAFEFE
AFDEC->BDABAEFADE
ABFEA->EFCDABDCED
CBECC->FDAFBFDEDA
DDEBE->CAEFADCDAD
ABDEA->BEAFEADCFB
BAEDE->CDBCDFCBBF
CDEEB->DAEFABDCFE
ECFDE->FCDEBCEFCB
EACCB->DFFEDFBACF
EEDBB->FADCFCAFAC
EDEBE->FCEFABAFDB
BCFFD->ACDEBEABCE
DECFB->AFDCFDEDCF
FABEC->ABFEEDFAEB
BDEBD->ECEFBFCDAE
EBFBE->ABAFBECDAD
DEDBC->AFDCAECDFD
EBAAD->ADCDDCBCAE
AFCCE->BCEDBFDEAD
BBBEB->ECAFEDFAEC
EBCFD->FACDBFABAF
DEDBC->AFDCAECDFD
ADAFF->DBEFCDABCB
AFABA->EFABDCCDFB
ECBCD->BABAECBAEB
AFACA->BCEDDCDEDB
FDDEE->CBCBFCDCDF
EEBEF->DBFAEDFADC
EEBDF->CBDCECEFCA
FCEBA->BCDEDBCDBC
CEEDC->DEFAFBEFEB
FBFBA->CACDCBAFBE
BCECB->DEBABABAEC
BBCAD->CFAFFDFEAE
AFBDC->FBABDECBFD
DDEBB->CECBBFCDCF
AAFFE->BEFEABEDAD
FBADA->BECDDCEFDB
CCAAE->DFBABEFEFA
AFCBC->BEABDECDBF
EAEDB->ADBCDFCBCD
ECFAC->FADEBEBCBF
EAEEC->ADBCDFDCDE
ECECA->BABABABADB
DDBFB->AFCBECEDCF
EADFA->FCFEFAEDFB
DBADD->EFCDDCEFAF
ABAFE->BEAFBCEDAD
DAEFC->FAFEADABEB
CBCFD->AFCDFDEDFA
ACDAC->DBDEAEBCFD
ADFDF->BECBACEFCB
EEFFD->FADCCBEDAE
FEBDF->ABDCAECBCA
BAEAA->CFFEFAFEBE
CBDDE->FDAFEBEFAB
BEDDB->ECDCFACBEC
ABCAA->CDCDAFBCBE
FBCCF->ADAFFDBACA
ECFAE->ABBADCFEAB
FFDDB->ACABAEEFED
CDDDB->DAEFEACBCF
CBCDD->EFCDAFEFEB
BBFBA->ECAFBCCDFB
DCBBB->EFDEEDCDED
ECCEB->BFDEDAFACD
BABAE->CDBCAEFEBA
BFFAD->ECEDCBFEBA
BEECA->CFDCFCDEDC
DCFFE->FCBADCEDAB
FFCBF->BCABFDAFBC
ECCAB->DFBADABCEC
ABADB->DBAFDCEFDA
ABBFD->BEAFCFEDFA
FADDF->ABFECAEFBE
FCEFC->ABDEDBEDEB
FEDDE->CBDCAEEFBF
BCEEC->EDBABADCFD
AAEFF->BEFEFAEDEA
DBDED->FACDBADCFA
AADFD->FBFEFAEDAE
EDCBD->ABCBFDAFEB
FEDFE->ADFAAEABFA
BAAAC->DABCDCBCAF
BEDFC->DADCFCEDBF
CCBDA->EBDEEDEFBE
CEBEE->FDDCECDCBA
DDFBD->EBEFBCCDBA
FAEEA->CBFEBFDCBE
AAAEF->CDBCDCFADC
EEFCC->DFDCCADEDA
BBBCC->EDCDEDBAEB
ADBFE->DBEFEDABDF
EEFFB->BFDCABEDFE
DCCFE->BADEDAABBF
ABBFF->DCCDEDABCB
BBAEB->CEAFBEDCEC
FDFDE->CAEFCAEFBF
ABEDF->BCAFDBEFBE
CBFBD->FECDBECDCA
CFADF->FDEDBCCBDC
EAAFF->BABCFBABAC
EBCCF->DBCDFDBACA
BCDCF->CFBAAEDEBC
CFEFF->DEABBAEDBE
CBBBE->FDAFEDCDBF
ABEAA->DBAFADBCED
ACEED->FBDEABDCAE
FDEFD->ABCBBAEDAE
CEEEB->FDDCBADCFE
DBAFE->CACDBEABBF
CFFFE->AFABACABAD
BAFEC->ECFEBCFAEB
AAEAB->EDFEABFEAC
BFBBD->CFEDCFAFEA
CCABF->EBDEFBCDEA
BDFBF->EDEFCBAFAD
FAACA->ECFEBCBABC
AABEF->CFBCAEDCAB
CFCBE->FEABFDAFBF
BFCCC->ECEDFDBAFE
BDFDC->DECBCBCBFD
AFEAF->BEABBFBCAB
AECAE->CFDCEBFEAD
EEDDA->FBFAFCCBFD
CCEDE->FDBAFCEFAB
CFFED->AFABACFAFC
FAAFA->BCBCDCABED
BDBFE->ECEFEDABDF
FBFFD->BECDEAABEB
AEEEF->CDFABADCEA
BAAAD->ECFEDCBCAE
DFBED->FAEDEDFACE
FEAEF->CADCBEDCAB
BDCEA->DECBFDDCBE
DFAFC->EBABCDABFD
AACBB->CFBCBFCDEC
FDBEA->CBCBECDCBE
BCCCC->EDBAEBDEAF
ACBDE->DCDEDACBBA
EDAFF->BFEFCDABCB
FCCCC->CBBAEBDEAF
EABFC->FCFEECEDFD
DFABF->BAEDBCAFBE
FEEFC->CADCBAEDAF
BDDCC->EDEFCEBADA
AFAFA->BDABDCABED
EFFDC->FAEDEAEFFD
BAFAD->CEBCBEBCFC
ECACC->FCDEDCDEBD
CABAA->BDFEECFEDC
DAFFF->BAFEABEDEA
CFCEF->DAABDEFABC
BAAFD->CFFEBEABEB
FEDFF->ABDCFCEDEA
BBBDC->FECDCFCBDE
CEBDB->EFDCFEEFED
BFAFD->FEABDBEDFA
CDBFE->FDCBEDABDF
CCFBF->BDBABCCDBE
BCFAD->EDBADCFEAE
ECFDC->ADDEBECBEB
DEFAD->EBFABCBCAE
FFEFF->ABEDADABDC
EFAAD->FCABCDBCAE
BEEDE->ACFAFBEFBA
CBDBE->AFCDAECDAB
BCBDB->ECBAEDEFEC
CEDEF->FEFAFCDCCB
FBEFC->CBAFBAEDAF
BABAE->CDBCAEFEBA
DFCBA->FCEDBFCDBE
AFDCE->DCABFCBABA
FFEFC->BEABBAEDAF
EDCFC->ADEFBDABDE
BFCAF->DAEDBFBCAD
AFFCC->DCABCBBAEB
FDBCA->BECBDADEFB
EAADD->BABCFBEFEA
DFFBA->EFABACAFBE
BCAFF->CFBABCEDEA
ECBEF->BABAECDCAB
ACDCA->BCBAAEDEDC
EEBFD->ABDCFEABAF
EDFBC->BFEFCACDFD
CBAAF->DACDDBFEBC
EFEFF->CBEDABEDBE
BFFDF->DAEDEAEFBC
FCADD->ADBABCCBCE
DFDFB->AFABAEABEC
AFDAA->BEABEBFEBE
FACBC->CAFEFDAFDE
DEBDC->FCDCAECBFE
BFABA->EDABEDAFCD
FEEBC->EAFAFBCDAF
CFBDC->EFEDFEEFDE
CBCAC->FDAFDEBCBF
ABEDF->BCAFDBEFBE
FAFEB->ACBCBEFAEC
EDFEA->FCEFBCFAED
ECFAA->BFDEBCBCDC
FCDEA->CADEAEFACF
CBBCA->DACDCEBABE
ACBDC->BEBACDEFFD
ECAED->BFDEDCFACE
EEFCF->DBFABEDEBE
CCFAE->BDBABCBCAD
CDEFD->AFEFBFEDAF
ECFFC->BABADCEDFD
DBDFE->FACDBAEDAB
DDFDE->AEEFCAEFBF
FBBAA->CBAFECFEDC
EBABD->ABAFCFCDCA
FBBBF->ADAFCFAFAB
AEDAC->FBFAAEBCFD
DFCEC->FAEDAFDCEF
AEEAB->CDFABABCED
AFDEC->BDABAEFADE
EABCD->ADBCAEBAEB
ACADD->BEBABCCBCE
EAECB->BFBCBABAEC
AFFEB->DBEDCBDCFE
BDEDB->CDEFABCBEC
DEFDB->EFDCCBCBEC
BBFEE->CFAFABDCDF
AEFEB->FDFABEFAEC
CDBFC->EFCBECEDFD
EDFBC->BFEFCACDFD
BDFFF->DACBDCEDCB
AAFCD->DCBCEADEFA
EDEAC->BFEFBFBCFD
EADFA->FCFEFAEDFB
CFCAF->EBEDBFBCAD
BDFFA->ECEFCAEDBC
CDFBE->AFEFCACDAB
DBCCE->AECDFDBAFC
BFECA->ECEDABBADB
FDACF->DECBCFDEBE
BADEF->CFFEFADCEA
EAFEB->ADBCCBDCFE
AECBE->FBFADACDFA
FDABB->CAEFCDCDED
ACACE->DCDEDBDEBF
EEFFC->FCFABCABFD
FFCCC->CAEDFDBAFE
BBDAB->ECAFEBFEEC
BFEFF->CDABBAEDBE
CEBBE->FEFACFAFAB
DCCEC->EBDEDFDCDA
EBDAF->ABAFBAFEAB
FFCBE->CBEDAFCDAB
BEFCF->CFDCCADEBC
AAAEF->CDBCDCFADC
EADCF->BABCEBDEAB
ACFDC->BDBACBCBFD
DBAEE->BACDBCDCDF
BCADD->CFBABCCBCE
BADCA->DEBCAEDEDC
BCBAD->CEBACFFEFA
DCDBD->AEDEAECDAE
CEDAE->FDDCFAFEAD
DBABC->AFCDFBCDBF
BDDDC->FEEFEBEFFD
ABEAF->CFCDADBCCB
FEFDE->BEFADCEFBF
FAFEB->ACBCBEFAEC
DCCEE->AFBAEBDCDF
DBFDC->AECDCBCBFD
BEFBA->EDFADCAFCD
FEBDC->BEFAECEFDE
DBFFD->EAAFADABEB
EAEDF->BABCBFEFCA
FCBDE->CBBAECEFBF
EBAAC->DFAFBCFEAF
CCDBD->FDBAEFCDCA
FEFEB->ADFABCFAEC
CCAEB->EFBADBDCEC
CBAFC->DFAFBEABDE
DCFEA->EFDEBEFAED
FABAF->DEFECFFEAB
CDBFC->EFCBECEDFD
BBDEE->DACDCAFABF
DCECD->AEDEBFDEAE
CDFEE->DFCBEAFAFB
DCDDF->AEDEAEEFCA
ADDEF->CDCBCEDCCB
ABFED->DBAFCBDCAE
BBFDC->ECAFBCEFBD
CAEFB->FEBCADABAE
FEEFA->BCFABAEDFB
BFECB->CFEDABBAEC
FEEBA->DCDCBACDFB
CCEBF->FEBABACDBE
DBCCD->EAAFEBDECA
CBACB->DACDDBDECD
BBAFD->ECAFCDABFC
BEDEB->CEDCAEFAED
EEDDA->FBFAFCCBFD
FADED->BEBCFCDCFC
AFCCD->BEABDEDECA
CFDBE->BDABEBCDAB
EDBEC->ADEFDADCEB
DFCDE->CAEDEBCBBA
CCCAA->FEBAEBFEFB
DFECF->EAEDFCDEBC
CDCCE->BDCBEBDEDB
FFBCD->CAEDCFBAAE
FABAE->ABFEEDBCAD
FEBAB->ADFACDBCAE
BEBEE->ECDCECDCBA
CBFAE->DFAFADFEFA
BFEFF->CDABBAEDBE
EFEFF->CBEDABEDBE
DCFFD->FABADCEDFA
EFCDC->ADABEBCBEB
BEBAE->ACFACDBCDF
FFCAB->ADABDEBCAE
FDDCC->CBCBFCBAEB
FCCCF->CADEDADEAB
BACCA->EDBCAFDEDC
ADEEA->DBEFBFDCBE
EDABC->FCEFBCAFFE
BFCFA->CFEDFDEDBC
CFFCF->FDEDCBBADC
DDEEE->FACBDFDCFC
FCCAA->CBBAEBFEFB
FEEFB->ACFADFEDFE
CDEBD->FDCBFCAFEA
EDCBF->BFEFDECDEA
AFDEE->BEABEBFAFB
FAFEE->ABFEBEFABA
BDDAD->ECEFEBFEFA
FACAF->BCBCAFBCAB
DBBCA->EBCDCFBABC
BCADB->CEBABECBCD
EDBCE->CDCBCFBAFB
ADDCB->EDCBEBDEEC
FFFFC->CAEDCBEDAF
CBDBF->FECDBACDCB
BBCCC->DECDAFDEDA
BCEBC->ECBABFCDFD
DCFAE->FABADCFEAB
BAFDF->ACFEABCBDC
BBDFF->DACDCAEDAB
BAEBC->FEBCBACDAF
ECAED->BFDEDCFACE
EFBCF->CBEDCFBABC
DCADF->AFBADBEFCA
AFDAB->EDEDFAFEED
CCABC->DEDEFBCDBF
BDDCB->CDEFEABACF
DFDBC->EFABEBCDFD
DFDCE->AFABAEDEBF
BCAEE->CFBABCDCDF
CBADA->EBCDFBEFBC
EFDEB->DFEDFCDCAE
CDAFC->ABEFDCABFD
EACEF->BFBCFDDCAB
FEADD->BEFAEDCBEB
DDDCB->EFCBCEBACD
FBBAE->ADAFCFFEFA
DFFEA->FCEDEAFACD
CECBA->FDDCEFCDFB
CDACA->BDCBFDBADC
CCEAD->AFDEBFBCFA
BDDCA->CFCBEBDEBE
CBABA->DACDDBAFDC
DDDCD->FACBFCBACE
BFACE->ECEDBCBAFB
ADECB->DCEFCBDECD
BDBAD->ACEFCFFEFA
BBDDD->CEAFCECBEB
DAEDF->AFBCADEFDC
BCDAD->CFBAAEBCFA
ADFFF->CFCBDCEDCB
DBAFE->CACDBEABBF
AAFBC->DCBCEACDEF
FDDAC->BECBCEFEDF
BEFAD->CFDCCAFEFC
FEDDD->ABDCFCCBCE
DCADD->EBDEBECBEB
BEADD->CEDCDCEFAF
BFCFA->CFEDFDEDBC
CBDBF->FECDBACDCB
ADBAB->EDCBCDBCAE
DCEAD->EFDEDBFEFC
CACBC->FDFEDACDEF
ADBDB->CFCBDACBDA
BADBD->FEBCFACDBA
BFCDE->CFEDFDCBFC
ABBDF->CFCDFEEFCA
ADBEB->CDCBDADCAE
EFADA->FCABCDCBFD
EAFFF->CBFEBCABCB
AAEDC->DBFEABCBFD
EFFFD->FCABACABAE
AEEEF->CDFABADCEA
FDECB->CBCBDFBACD
ADAEA->BCCBFDFACF
CCEDF->DADEABCBCB
BFACA->CDABFDBADC
EDDDC->FACBCECBDE
BFABD->ECEDBCAFBA
BACBA->DEBCAFCDBC
AFBCC->BDABEDBAEB
FBAFE->ADAFBCEDAD
ECAAF->BFDEDCBCEA
BABBB->DEBCFECDCF
FFADB->DCEDBCCBDA
DEEDD->BCFABFEFEB
FDAFB->DCEFCDABFE
FFBBF->DEEDECAFBC
FABBB->EABCAEAFCD
FEBBB->CADCECAFED
ABCCC->FBCDBFDEFD
CCBAB->FEBAECFECD
BCEAF->ACDEDBFECB
FEDCC->ABDCFCBAEB
DEDEA->CEDCFCDCED
ABFBF->CFCDEACDAD
BEBFF->ECDCECEDCB
BABFA->DABCFEABDB
EAAEC->FCFEBEDCEF
CECDC->FDDCEFCBFD
CECCD->AFDCEFBACE
AFABF->BCEDDCCDBE
BBCEE->ACAFFDDCBA
FDEFF->BCEFCBEDCB
AFBEE->CFABFEFAFB
CCDDA->DADEFACBED
BDCDE->EDEFEBCBBA
EBCAA->DFAFFDFEDC
CEBCC->FDDCECBADE
BDCAD->CECBDABCFA
EDBDB->ADEFDACBDA
DAFFE->CABCABEDAD
FCEBC->CADEBFCDFD
FEDCB->ADFAAEDECD
FDFEE->BECBDCDCBA
CCBCA->FDBADEBADB
BBECE->CDCDADDEDB
FCADD->ADBABCCBCE
DFFFB->FCEDEAABDE
BFFFD->CFEDCBEDAE
CBFAA->DACDADFEBE
DDCDE->AFCBFDCBFC
ADAAA->DBEFCDBCDC
FBDDA->DCAFEBEFBC
FECDC->CADCEFCBFD
FBEEA->DCAFBFDCBE
FFBDC->EAABDECBFD
EAABD->ADBCEDAFEB
AABCA->BCFEEDBADB
BCABF->DADEFBCDEA
FBABA->ECAFDCCDFB
ECEAF->ABBABABCBE
CFFBA->DEABDCAFCD
EDBEB->DFCBCDFADA
FAEFE->CAFEBAEDBF
DDECF->EBEFABBADC
BCDAB->CEBAFCFEED
AFCBC->BEABDECDBF
EBAFE->FCAFBCEDAD
FBCCB->CBAFEBDEED
CECBC->DEFADACDEF
BEAED->ACFACDFACE
ECEFF->ADDEDBEDAB
DFAEE->FAEDFBFAFB
BFEED->CFEDABDCAE
AFEEA->CDABDFDCBD
FFDCB->CAEDFABAEC
DCAFD->EABABEABEB
EECAE->FBFAFDFEAB
FAAEC->ADFEBEDCEF
EEFFF->ABDCEAABAC
CFEED->BFABFADCFC
DCFEB->AFBADCDCEC
DAADA->AEBCBECBCD
EBEAB->FCAFABFEAC
FEACB->EAFACDBAEC
AAACF->DBFEDCDEAD
EECDC->BFDCEFCBFD
BDAAA->ECEFCDBCDC
ECBCF->ADDEEDBADC
ABCAE->BCAFFEBCAD
BCBAC->DEBAECFEDA
CFBAA->EBEDFEBCBE
FAECC->ADFEFADEAF
BFBBB->CEABEDCDED
EFEFD->BFEDBAEDAE
EFEDC->FCABBFEFDE
EECCF->ABDCFDBACA
FEBFD->EAFACDABCE
DDEDE->FCCBBACBDF
BDCFD->ECEFDEABCE
BEADA->CDFAFDEFCD
ACBFA->EFDECFEDBC
CBFAD->EFCDBEBCFC
EEABE->FADCEDAFBF
BFECF->DAEDADDEBE
FEABD->ADFACDCDBA
CFEBD->EFEDADCDCA
CDBDF->FECBECEFCA
ADECD->CFCBBABACE
BCEFA->ECBABFEDBE
BECEF->CDFABDFABC
CBADA->EBCDFBEFBC
BEAEF->ECDCBEDCAB
FACEF->CAFEFDDCAB
EEDBF->BFDCFACDBE
ADDFD->BECBEBABEB
BFEEF->EDABDFDCCA
FEBEF->ADFACDFAEC
BEBFB->CDFADAEDFE
CCEBD->BFDEADCDCA
BFEAE->ECEDABFEBF
CDEFC->DAEFABEDAF
DFEBF->AEABFACDEA
BADDD->ECFEAEEFEB
DADEA->EFBCFCDCED
FFEFD->CAEDABEDAE
CEFDE->DFDCBECBBA
BEBCF->EDFAECBABE
CBAFF->DECDDCABCB
EDAFF->BFEFCDABCB
BECAD->ACFADABCFA
DBADA->FCAFCFCBFD
CCBAE->FDBADEBCAD
EBDBF->BACDBACDCB
ABDCF->BCAFBADEBC
ADCBF->DBEFDECDEA
BBCCF->CFAFFDBACA
ABEFE->CFCDADABBA
CAFCC->DEBCCBBAEB
CACEB->DEBCBFFAED
FEEDF->ACFADFCBAC
DCCDD->BCBAFDCBEF
FAADE->BCBCDCEFCB
EAEBB->FCFEFACDFE
AAFBD->FBFEABAFEA
CCBAF->DADEECFEBC
BABDD->ACFEECEFEB
CDCCB->DAEFFDBADE
FCFCD->ADBABCDECA
FBBBA->DCAFEDCDFB
BCCBD->CEBAFDAFEB
AAEDE->BCFEADEFCB
AFEDD->BCEDADEFAF
CABAA->BDFEECFEDC
DEBAA->AEFAEDBCDC
BBDEA->CFAFEADCFB
ABBDC->EDAFEDEFEB
CEFBE->DAFABCCDBF
AFEAB->DCABDFFEEC
CDCEC->FDCBFEFAFD
BEDEC->ECDCFADCFD
EEDAC->DFDCEFBCBF
FEFED->CBDCEAFAAE
FFBDD->BEABAECBEF
CDCFD->FDCBFEABFC
EEDCC->FADCFCBAEB
BDAFA->CFCBCDABED
DFFEF->CEABACFACB
BFBEE->DAEDFEFAFB
CCFFB->DEDEBEABAE
FEDDD->ABDCFCCBCE
EBDCE->FCAFEABADF
EBCAB->ADCDBFBCDA
DEAFA->AEFACFABED
CECED->FDDCEFDCAE
DCFDD->AEDEBCEFAF
AEBFF->DBDCECEDCB
BABCC->DEBCFEDEDA
BACBF->EDBCAFCDCB
CABED->FEBCFEFAAE
EDBEC->ADEFDADCEB
ACDEE->FBDEFADCAD
BDAFE->DACBFDEDBA
AEAFC->EDDCBEABDE
AEFFD->BCDCCBEDAE
EFCFA->FCABDEABFD
BFDAF->ECEDFAFEBE
CBEFA->DACDFAEDDC
AFFDA->DBEDCBCBED
AAAFC->DBFEDCABFD
FDBFB->CBCBECEDCF
ABFDF->DCCDBECBDC
BBFEF->CDCDEAFABC
FBBDF->ACAFECEFCA
CFBAC->DAABDEBCAF
DADAE->FAFECABCBA
DBFEA->AFCDBEFAED
AEEBB->DCFABACDED
AEBAF->CFDCAEFECB
FCEFE->BCDEDBEDBA
BCBDA->DADEEDEFBE
EBFDA->DFAFABCBFD
AEEFF->DCFABAEDBE
DBDAA->FCAFBAFEBE
FACEB->DCFEDAFACD
CACBD->BFBCEBCDBA
AABAF->DCBCFEBCAB
EBFDB->ADCDEAEFCF
CDAAD->FECBEDFEAE
EACEC->BABCFEFAFD
ABBDF->CFCDFEEFCA
AFCBD->BCEDBFCDFC
CCFBA->EBDEBECDDC
AEDCE->FBFAAEDEBF
FEEFF->DEDCBFEDAB
BBFAD->ACAFABFECA
CABFF->BDFEECEDCB
DAFDC->EBFEABCBEB
EFDEB->DFEDFCDCAE
EDCCF->ADEFBDBABC
CCBCE->BDBACDDEDB
BBFFE->ECAFBCABDF
EFADD->ABEDFBEFEA
FBBEA->BECDFEFACD
AEBAD->DCFAECFEAE
CBAAC->EFCDFBFEDF
CDBDC->FDCBEDEFEB
ACCEA->BDBAFDDCBE
BABEB->CFFEECDCEC
AAFDE->DCBCEAEFAB
DEEBA->EFDCDFAFBC
FDBCE->CBCBECBABF
EDFCF->CBEFCADEBC
CDEFF->BDCBBAEDBE
EADFE->FBBCEBABBF
ADBAB->EDCBCDBCAE
FAFCC->ABFEBEDEAF
ADFED->FBEFBCFACE
DAAEB->AEBCBEDCEC
CDACF->FECBEDBACA
CDDFA->BDCBCEABCD
CDEDC->ABEFADEFBD
BFECA->ECEDABBADB
DEFCB->AFDCEADEEC
BAEFF->CFFEFAEDEA
DBABA->EBCDBCAFCF
EEEDD->BADCADEFAF
EFFCC->BAEDBEDEAF
DEFED->BCFABEFACE
DFFEE->AFABEAFAFB
CBCAA->BDAFFDFEDC
CDABC->DAEFBCAFFE
ECFEE->BFDEBCFABA
ACCEF->CDBAEBDCCB
CFCDF->DEABEBCBDC
CFDAF->FDEDFAFEBE
FFFBC->EAABACAFEB
AFBDA->BCEDFEEFCD
BFFBD->CEABEACDFA
FDBBA->CAEFEDCDFB
EAEFA->CBFEABEDFB
EFFEA->FBABEAFACD
EEBBC->FCFACDCDBF
CDFEF->FDCBCADCAB
EFCBF->ABEDAFCDCB
ABFFF->BEAFABEDEA
ACABB->FDBADCCDED
CFBAD->AFABDEBCAE
AFEDD->BCEDADEFAF
DFEFE->CAEDBAEDBF
ADBFF->BECBCDABDC
EDBBB->FCEFCFAFCF
DEFAD->EBFABCBCAE
DAFAC->FAFEBEBCBF
BCBCE->ACDEEDBABA
CDAFA->DAEFBCEDDC
CBFDF->FECDBECBDC
CECBD->FEFAFDAFEB
FAACD->EABCEDBAEF
ADFCF->BCCBDCBABC
FAFBA->ECFECBAFBE
FDAFB->DCEFCDABFE
DCAEA->AFBADBDCBE
CAAEF->BDFEBEDCAB
FACCF->ABFEAFDEBC
FFFEE->CBEDBEFABA
DBFCE->AFCDBEDEDB
ABCEA->DBAFDAFACD
CBFFB->FECDBEABAE
CCFAB->DADEABFEED
CCFBB->FDBACACDCF
AEBCB->CFDCAEBAED
CBAEF->FECDFBFABC
CBFDB->EBCDBECBDA
BEFED->EDFADCDCFA
DBBEA->FCAFACFACD
FEEBF->ADFAFBCDBE
ADABB->DBEFCDCDED
CCBAD->EBDEEDBCAE
CDACB->EBCBFDBAED
DCDCD->EABAFCBACE
FCAAD->EADEBEFEFA
FADEA->DCFEAEFACF
BEEAA->EDFABABCFB
ECBFE->FCDECDABBA
CFBAA->EBEDFEBCBE
BABBB->DEBCFECDCF
CBEFD->EFCDBFEDAF
AABEF->CFBCAEDCAB
DACEB->EFBCBFFAED
CAFEF->FEBCEAFABC
ACBEE->BCBACDFACB
CDBAB->DECBDABCFE
AEFCE->DBDCABDEDB
CFCAD->FEABFDFEAE
FDEDD->EAEFABCBFC
FECFC->EAFADAABDE
CBFEE->DACDADFAFB
ACDBD->DBDEAECDAE
DACAE->AFBCAFBCBA
ACDCD->CFDECADEFC
DEBDB->CEDCAECBED
CDBEF->DECBDADCCB
FEECB->DCDCBABAEC
CDEEC->DECBBADCFD
EADDE->FCFEFACBDF
CCCEF->BDBADAFABC
FCCFC->CADEDAABDE
FBFBD->CBAFADAFEA
FFAFC->ADABCDABFD
CFCBC->DAABDECDBF
BCDBD->ECBAEBCDAE
AACBE->BCFEAFCDAB
BFBAE->EDABFEBCBA
FAAAC->BEBCEDFEDA
CDDFC->FDCBEFABDE
BDDCC->EDEFCEBADA
EBECB->ADCDADDEED
DDDEC->EBEFEADCDA
DDFEB->EFCBDCDCEC
CCFDF->DEDEBECBDC
EFEAB->BAEDBFBCEC
BDAFB->CDEFBCEDFE
CEDFE->DAFAAEABFA
CDDDF->EBCBCECBAC
BFDCF->ACABEBDEAB
CEDDE->FEFAFCCBBA
EFFCA->FCABACBADB
BFDAF->ECEDFAFEBE
CDCDA->EBCBEBCBFD
DFCEE->AEABEFDCAD
AFEFC->BDABADABEB
ECEAE->CDBABFBCBA
ADAAC->EDCBCDBCAF
EACAA->FBBCFEBCDC
DDCDD->EFCBEBCBCE
ECACA->FBDEDBDEDC
EFBCC->ADABAEBADE
EBBAA->BACDEDBCDC
BFEDE->EDABDFCBBF
CABDB->DEBCAECBED
ACCEB->DBDEDAFACD
CAFED->BFBCADFAAE
CFECB->DAABBFDECD
FADDC->BEBCFCCBEB
ADFAA->BDCBCBFECF
DBBEF->CEAFCFDCCA
BFFED->FEABADFAAE
DACCF->BAFEDFBACB
BBEBF->ACAFABAFBE
EECCC->FCFADADEDF
FFEAB->CBEDBFBCEC
CADCB->EBFECADECF
CBBBE->FDAFEDCDBF
CCCAD->FDBAFEBCAE
EDFBF->BACBCBAFAD
FCEEA->ECDEBFDCBE
FCCEC->ADBADAFADA
CFBCC->DFEDEDBAEB
EAEAD->ABFEBFBCFA
BCEBD->CFBAFBCDBA
EAECA->FBBCBFDEDC
DAABF->EBFEBEAFAB
ECCAE->FCDEDABCBA
BEDEB->CEDCAEFAED
DEDCB->EBFAAEDECD
DBEBE->AFCDBFCDAB
CFACB->FEABEDBADE
DFFCD->FAEDBEDECA
CBBEA->EBCDEDFAED
DFDCC->EBABEBDEDF
EFDDB->ADABCECBCD
DDEDC->AFCBDFCBDE
CECBC->DEFADACDEF
FCECA->CBBABABADB
ADFFC->EDCBACABDA
CCDAE->AFDEAEBCBA
DDFFA->AEEFCAEDBC
DDEFA->FCCBBAEDFB
ACFDF->BCBABCEFDC
EEDAA->CBDCFAFEFB
DEBEF->EBFACDFAEC
FCDEF->ACBACEDCCB
CAEEF->DEBCDFDCCA
BCADE->CDDEFBEFAB
FFCCB->ACABDADEEC
EEABB->ADFAFDAFCD
BDAEA->CDEFBCDCED
ABFAB->EDAFBCBCFE
BDCBE->DACBEBCDBF
CBFDF->FECDBECBDC
DAAAB->CEFEBEFEEC
EFACA->CBEDBCBABC
BABEB->CFFEECDCEC
CABEA->FDFECDFAFD
DFFBB->AFABEACDCE
CAAFA->BDFEBEABCD
DFAEE->FAEDFBFAFB
FCECF->ABDEDBDECB
EAECE->CDFEBABABA
FDEDD->EAEFABCBFC
BAACD->ACFEBEBAAE
BBABB->CDCDDCCDED
FEEFF->DEDCBFEDAB
CCAEA->FEBADBDCBE
BCBEA->DEBAECDCBE
DFBFD->BCEDECEDFA
ECEEB->FADEDBFAED
ECBFC->ADDEEDABFD
EFCBC->FCABDECDBF
CBFAE->DFAFADFEFA
CEFAB->EBDCCBFEAC
CAFBC->ABFECBAFEB
FEDEC->CADCFADCFD
EAAFD->FCFEBEABEB
CCDAB->EBDECABCEC
ECBBB->FADEEDCDED
BFAEA->ECEDBCDCED
FCADC->CADEDCEFBD
FCCCA->ECDEDADEBE
CAFDC->DABCABCBEB
ECCDE->ABBAEBCBBA
ABBDB->FDAFCDEFCF
BBCAF->EDCDAFBCAB
ACDDC->DCDEAFCBFD
CDDCD->EFCBFCBACE
BBFAF->ECAFBCBCEA
FAFDD->ABFEBECBCE
ADDFA->CDCBCEABCD
FCABD->CBBADBAFAE
CFEDE->FEABDFCBBF
EEEDA->BFDCBACBED
ADBAD->FBEFCFFEFA
DBDCD->AECDAEDEAE
BBFDD->CFAFABCBCE
CBABC->ABAFBEAFFD
EECDF->BADCFDCBCA
BDAFF->ECEFCDABCB
FCBEC->CADECDFABD
CFDCC->DAABEBDEDF
DCDBD->AEDEAECDAE
CDFEF->FDCBCADCAB
ACBDB->DBDECDEFCF
BDECC->DECBDFBADA
CEAAE->FEFADCBCAD
BACCC->DABCAFDEDA
EFDEE->FCABEBFAFB
EDEBC->ADEFCBAFFD
DBDFF->EAAFCEABAC
CEFDE->DFDCBECBBA
FFCAE->BCABFDFEAB
FCAEB->EADEBEDCEC
BECCA->DADCEBDEFB
CEAAA->EBDCEDFEDC
CCCEA->EBDEAFDCBE
BCFDA->EDBADCEFCD
CAAFA->BDFEBEABCD
CFDDD->BFABAFCBFC
AAFBF->DBFEBCCDBE
CACBD->BFBCEBCDBA
DCAAB->EFDEFBFEEC
DDACE->BAEFCDBABA
DFBBB->FCEDFECDCF
DDEBA->AFCBDFAFBC
BDBED->ECEFEDFACE
EFEFF->CBEDABEDBE
AADAE->FBFEFAFEAD
BCEFA->ECBABFEDBE
ACABC->EDBACDCDAF
FECBA->CADCEFCDFB
CFCCF->FEABFDBACA
AACEF->DBFEDAFABC
CFBED->EFEDFEFAAE
CFBFB->DAABDEABFE
DFABF->BAEDBCAFBE
DFBFB->EBABDEABFE
BDDED->FEEFEBFAAE
DECBF->EADCDACDAD
DDCEE->BAEFDEFAFB
FFCEC->EAABDEFADA
CDBEC->DFCBCFDCDE
ABBCA->BEAFCFBABC
CFFDC->DEABDCEFDE
BDFAA->DACBDCFEDC
CABAC->FDFECDBCBF
FCACA->BEDEFBDEBE
CDDFC->FDCBEFABDE
BBCAA->DECDAFBCBE
DBFFA->EFCDEAABCD
CDEEE->BDCBBADCAD
DCAFC->FABADBEDFD
DCBDD->EFDEEDEFCE
FACBF->DEFEFDAFBC
ACDED->DCDEAFDCAE
FDDEE->CBCBFCDCDF
BDDEE->EDEFCEDCDF
FECCA->BEFAEBDEFB
DDABB->AEEFCDCDED
CDAFF->FDCBCFABCB
FEEEB->CADCBADCFE
EFADE->FBABDCEFCB
ECEDB->BABABACBEC
BDBAA->CFCBCDBCED
CDFAE->FECBCBFEBF
FFBFB->ADABDEABFE
AEDFD->DBDCFAEDAE
FFEDF->BCABDFCBAC
BEAAA->DADCEDFEDC
EDAAD->BACBEDFEAE
AECCB->DBDCEFBAEC
CBBBC->EFCDEDCDAF
CBFFE->FDAFBCABDF
DECDE->BADCEFCBDF
CFAFD->AFABCDABFC
AEEFC->DBDCBAEDAF
CFDDF->FEABFCCBDC
DFBCF->BAEDCFBABC
FEDCC->ABDCFCBAEB
DCABE->FABADBAFAD
ADCDE->DCEFBDCBBA
CEDAB->FEFAFCFEED
BBEFD->ACAFABEDAE
EDDBE->BFEFEBCDAB
AFFAB->CDABCBFEAC
BCDEA->ECBAEBFACD
CBDDC->EFCDBAEFDE
ECEDC->DFBAFBEFEB
ABADC->BEAFBCCBEB
CFBDD->EBEDFEEFEB
CEDDA->EBDCFCCBFD
BBFEB->DECDBEFAEC
BFFDF->DAEDEAEFBC
EBBEA->FBCDEDFAED
BAEAF->ECFEABFECA
FFCEF->ADABDEFABC
DBBAF->BACDCFFEAB
DEEBC->FADCADCDBF
ABAAD->CFCDDCBCAE
EAFAC->DFFEABFEAF
BEAEC->EDFAEDDCEF
BCAEA->EDBADBDCBE
BCDFC->AEBAEBABDE
EFDCC->FCABEBDEDF
CBCBE->DACDEFCDBF
CAFAF->DABCABFEBE
DAEBE->FAFEADCDAD
EACFF->ADBCBFABAD
EBFBD->BACDBECDCA
CDFBB->EBCBDCAFED
BBBAA->EDCDEDBCDC
ECEDD->ADDEDBEFAE
FFBEE->BEABAEDCBA
BBCCF->CFAFFDBACA
DBCEE->FACDAFDCBA
ACDDB->EDBAEFCBDA
CCADE->AFDEDCEFCB
DBABA->EBCDBCAFCF
AFCAD->DCABFDFEAE
FDFBB->ACEFCBAFEC
CDCCC->DECBEBDEAF
BBAEF->EDCDFBFABC
BEBBD->FEFACDCDCA
BFFBB->FAEDABAFCF
CFCEB->FEABFDDCEC
BEACC->DADCEDBAFE
CAFBD->EFBCEACDFA
FCFCF->DEBABEDEBE
EDDAB->DFCBEBFEEC
ACEDF->BEBAFBEFCB
DDECE->AEEFBFDEBF
EDDBC->DFCBEBCDFD
FCABD->CBBADBAFAE
AFCDD->DBEDFDCBEF
CFCCC->FDEDFDBAFE
DCFAB->EBDEABFEED
FBFCD->ABAFABDECA
BDFAF->ACEFBCBCEA
AEEBB->DCFABACDED
CDFCF->DECBDCBABC
DAEEE->CABCBADCAD
AABBC->BDBCEDCDAF
CDAAC->DECBFDFEFD
FCDBC->BEDECACDEB
DDCAC->FACBFDFEDA
DDDFC->AEEFEBABDE
DEABA->CEDCEDAFCD
EAFDB->BFBCABCBDA
DCEDC->FABABACBFD
CBDBA->BDAFEAAFBE
BAACA->CFFEBEBABC
EFBDD->ADABAECBEF
ACBAF->BEBACDBCCB
DFABB->CEABCDCDED
ECCCC->BABAEBDEAF
CBDFA->FDAFEBABCD
AFECF->CFABDFBABC
FBEFE->BECDADABBA
BAEBE->ACFEFACDAD
BBDFC->FECDAEABEF
ADBCE->DCEFDADEDB
CEFDA->DAFABCEFDB
DDCCD->BCEFDADEFA
EBFDC->BFCDCBCBFD
DECAA->EBFADABCBE
BCBCE->ACDEEDBABA
BBACF->DACDDCDEAD
BAEAC->EDBCADBCBF
BCFDE->CFBABCEFCB
DDBED->AEEFEDFACE
EBAAA->CBAFBCFEFB
DDDBC->FACBFCAFFE
EBDEF->BFCDAEFABE
DCCBE->AEDEDACDFA
EEFBA->BADCEACDDB
EEFFD->FADCCBEDAE
AABEE->FBFEECDCBA
DFFDF->EAEDCAEFCA
FABDE->BEBCAECBFC
EDEAB->ADEFCBFECD
CADEB->FEBCAEFAED
BAFFD->ECFEBCABFC
CAACC->ABFEBCBADA
DCDED->BCBAFCDCFC
CFEAD->EBEDADBCFC
AFCBA->BDABDACDDB
DBCDD->FACDAFEFEB
CBACC->DECDDCDEBD
FFDDD->ADABEBEFEA
BABEF->DABCFEFABC
BDAED->CECBDCFACE
DCEBA->CEBAFBCDFB
DBDFE->FACDBAEDAB
DFBCB->CEABDEBAEC
FDBEE->ADEFEDFABA
DAECC->EBFEFADEAF
DEBAC->EFDCAEFEFD
BFBBE->CDABAEAFAD
FFECC->ABEDADDEAF
BCDAA->DEBACEFEBE
AFAAD->BEABCDBCAE
CCBBF->FDBADECDBE
BFCAC->FEABEFBCAF
CBCFF->BDAFFDEDCB
DFACB->AFABDCDEDA
EEEBD->ADFACBAFEA
AEFBD->DBDCABAFEA
FAFFF->ABFEBEABDC
DCBCD->BCBACFBAAE
FEDCD->CBDCAEDEAE
FAECE->CBFEBFDEBF
AECAA->BEDCEFBCDC
FDDBE->CAEFEBCDAB
EEFDE->FBFACBCBDF
FBACA->CACDBCBABC
CDFFF->EBCBDCEDCB
AAFBA->BEFEABAFBC
EEADB->BADCDCEFDA
EFBAB->BFEDECFECD
CDACD->BFEFDCDEAF
AEDFC->BDFAFCEDBF
FACEA->ECFEFDDCBE
EACDA->CBFEDAEFBC
EEBAB->FCFACDBCAE
DADDD->AEBCFACBFC
EDADC->ADEFDBEFDE
EEBBB->BFDCECAFED
ABAAB->DCCDFBFEEC
BEFED->EDFADCDCFA
AAFEF->DCBCEAFABC
BCDBC->DADECACDEB
EDFAF->ABCBCBFECA
EDDCC->BACBFCBAEB
BECCD->FEFADADEFA
EADCC->BFBCFABAEB
EDFFF->ADEFDCEDCB
EFADB->FAEDDCEFDA
CBEDC->DFAFBACBFD
EADCD->FCFEFABACE
EFEAA->CBEDABFECF
DAFDC->EBFEABCBEB
EFDEA->BAEDAEFACF
FDCDF->BCEFBDCBDC
DBDCE->CACDFCBABA
FDFBF->DECBCACDCB
CEAFE->BDFACDABDF
AABFA->BDBCEDABED
FDCDD->ABCBEBCBCE
ACBBD->FBDEECAFEB
ACBAD->CFDEEDBCAE
ECBDC->FCDECDEFFD
ACDED->DCDEAFDCAE
EDECA->CBEFBFDEDC
BBDCB->DECDBADECD
AECCC->BEDCEFBAEB
DEEED->EFDCDFDCEF
ACCDC->EDBAFECBFD
FAFCD->CBFECADEAE
FFBBC->CAEDCFAFFD
DCBFB->CEBACDABAE
FEDBB->DCDCFACDED
FBCDF->CACDFDCBCA
CDEDD->EFCBDFCBEB
BECBF->DADCEBCDBE
CEEAF->DEFAFBBCBE
ACFEB->DCDEADFACD
FAFEE->ABFEBEFABA
EFDFD->ADABCEABEB
AABCC->FBFEECBADE
DCEAD->EFDEDBFEFC
BBACE->ACAFBCBAFB
BCDCF->CFBAAEDEBC
AEEFD->BEDCBAEDAE
EFEDE->CDEDBACBDF
ABECF->DCCDBFDEBC
CACCF->DEBCBFDECB
FCFDE->ADBABCEFCB
CFBCE->DAABDEBABA
CDEDB->DECBBACBEC
DBDBB->FCAFBACDCF
DCCEA->FCBAEBDCED
CFBFE->BDABDEABDF
FCDBE->ADBAAECDAB
FFDBF->ACABAECDCB
EBAFD->BFCDBCEDFC
FFCEE->CAEDFDDCBA
ACFBA->BDBACBAFBE
CFFEC->DAABACFAFD
FFECC->ABEDADDEAF
FBBFF->DEAFCDABDC
DFDCC->EBABEBDEDF
DFFCD->FAEDBEDECA
EAFFF->CBFEBCABCB
BCDBC->DADECACDEB
DFBCB->CEABDEBAEC
FEFBD->CADCABAFEA
CCADE->AFDEDCEFCB
CDFAD->AFEFCAFEFC
CAEAA->DABCBABCFB
CCBDE->FEBAECEFBF
FFBAF->BCABFEBCAB
CCEEF->FDBAFCFABC
BFEDE->EDABDFCBBF
BDAAC->FEEFCDBCAF
DEADA->EFDCEDCBCD
CBAED->BFCDBEDCFA
EBDDD->ADCDCAEFAE
CCDAD->BFDEFCFECA
AECBA->DBDCEFCDFB
BEBDE->CFDCDECBDF
EBFAB->FACDEABCAE
EDAFF->BFEFCDABCB
BBCAC->ECAFDEBCBF
AEACF->BCDCEDBACA
BDFDD->CECBEAEFEA
CFCEA->DEABEBDCED
AFCEB->DCABFDDCEC
DFCDC->FCEDBFEFDA
BCCBD->CEBAFDAFEB
BDBCE->EDEFECBABF
BCBFF->CDDEEDABCB
ADDCA->BECBEBDEBE
ACDBA->EFDEFCAFCF
CDDCD->EFCBFCBACE
ABAFE->BEAFBCEDAD
CDBAE->DFCBCFFEFA
DAFAC->FAFEBEBCBF
CFACE->FDEDBCBAFB
BFFDF->DAEDEAEFBC
FADAB->ADFEFAFEED
EBFEC->ADCDEAFADA
FCCCF->CADEDADEAB
ECBDB->BFDECDEFCF
EBFFF->DBCDCBEDBE
CDABC->DAEFBCAFFE
ADAAF->CFCBFDFECB
DFAAB->FCEDDCBCFE
DDADE->CAEFDCEFCB
DDCFF->BAEFDEABDC
EDBBB->FCEFCFAFCF
EBDEF->BFCDAEFABE
EFBDC->DFEDFEEFDE
ADDCE->CFCBCEBAFB
AEBAF->CFDCAEFECB
EBBDF->ADCDFEEFCA
BDACB->CECBDCDEDA
AEFAF->DCFADCFEBC
DCFAE->FABADCFEAB
DDEBD->AEEFBFCDAE
EDBEE->FCEFCFDCFC
EFDEF->CBEDFADCEA
EDAEE->BFEFCDFABA
FFAAC->CAEDBCFEAF
BACEF->ECFEDAFABC
AFCFF->DBEDFDEDCB
BADDF->CDBCFCCBDC
CEEAD->FDDCBABCEB
BABDD->ACFEECEFEB
CECFE->FDDCEFEDAD
FAAFB->ACBCFBABDE
DDDCD->FACBFCBACE
DAAEF->CEFEBEDCAB
FECAA->ECFADEBCED
FACEE->BEBCBFFABF
BFBEB->CDABAEDCEC
ECEEF->BFDEBFDCAB
CBDFE->BDAFEAEDFC
FCCCF->CADEDADEAB
AEBDA->EFFAEDEFBE
EEBFB->FADCAEEDEC
EDFEE->FBEFCBDCAD
DEBEA->EFDCAEDCBE
EFABC->ADABFDAFDA
BCBCB->CFBACDDEED
EBFAC->BACDBEBCBF
EDAFE->FBEFBEABBF
ABDAF->CDCDBAFEAB
ABEFA->BEAFABEDFB
DCDCD->EABAFCBACE
DAEBC->EFBCDFAFFD
ADEAA->CDCBBABCFB
EDCFD->BFEFDEABCE
BBADB->ECAFCDCBDA
AFBBF->DCABFECDCB
FCBBA->ECDECDCDDC
BDEBB->DECBDFAFCF
DFFAC->FCEDEABCBF
CDBCB->FDCBEDBAEC
EDCCB->FCEFFDBADE
DAFBD->FAFEBECDCA
ACADD->BEBABCCBCE
CEBED->EBDCAEDCFA
EDBCC->FCEFCFBADA
DBFBB->EBCDCBAFEC
CBCFF->BDAFFDEDCB
CBCBE->DACDEFCDBF
CCCAC->DFBAFDFEDA
EBECE->FACDADDEDB
EBCDF->BFCDFDCBCA
BBEEB->FACDBADCFE
FDEDE->BECBBACBDF
EBBDB->FCAFCFCBCD
DACBA->CEFEDFAFBE
CAEDF->FEBCADEFDC
EDDDE->ABCBFCCBBA
ABFDE->BCAFBECBBA
BFCFC->EDABFDEDFD
DAAFC->AEBCBEABDE
EFABE->FCABCDCDBF
BBBFA->DECDEDABED
DAEBE->FAFEADCDAD
AEFFF->CDFADCEDCB
DCFEE->AEDEBCFABA
DCBCC->EFDEEDBAEB
DEBCD->EBFACDDECA
FADCB->ACBCEBDEEC
ABDCF->BCAFBADEBC
FDDEB->CAEFEBFACD
EBCCC->DFAFFDBAFE
FDCDF->BCEFBDCBDC
DBEEA->EFCDADFAFD
FEDFE->ADFAAEABFA
EAEAC->BABCBFBCFD
DEFEC->EFDCCBDCFD
EEEBC->DFDCFCAFFD
CAAED->AFBCBEDCFA
FABAA->BCBCFEBCBE
FBFBE->BCCDBECDAD
CEEAB->EFDCADBCAE
BAEBC->FEBCBACDAF
EEFCF->DBFABEDEBE
AAAFB->CFBCEDEDCF
ABADD->BCAFCFCBCE
DDCAC->FACBFDFEDA
CCEBA->BDBAFBCDFB
DCCBF->EBDEDFAFAD
DFEFA->AFABADABFD
AADED->CFBCFCDCFC
EDAEA->CBEFCDFAED
DDBFB->AFCBECEDCF
CCAFC->EFBADBEDFD
ECBDF->ABBAECEFCA
CAEEB->EFBCADFADA
AFDCB->DBEDFABAEC
BEEBD->CEDCADCDCA
FDEFD->ABCBBAEDAE
ECFAF->ADDEBEBCCB
DCFDC->FCBADCEFDE
BBADB->ECAFCDCBDA
CDEBE->DAEFABAFDB
CFFFC->FDEDCBEDAF
AACEC->DCBCAFDCEF
BBBFD->CFAFCFEDFA
FABBF->ABFEEDCDBE
FAAEE->CBFECFDCDF
CFBDA->DEABAECBCF
EBCFC->FCAFFDEDFD
BDEAA->DECBDFFEBE
AECCE->DCFAEBDEDB
EBADD->FACDDCEFAF
EEBFD->ABDCFEABAF
EBBEA->FBCDEDFAED
BDEFE->EDEFBAEDBF
CBDAF->BDAFEAFECA
DEAEC->AFDCDCFAEB
ABFEA->EFCDABDCED
ABBBD->CFCDFECDAE
DCEFA->AEDEBFEDBE
BDCFC->DACBEBEDBF
EAEBA->BFBCBACDFB
EDBFD->ADEFDAEDFC
DCDAF->AFBACEFEAB
DFCAB->EBABDEBCAE
BDECF->CFCBBFDEBC
EDEEC->FACBBADCFD
CDDAB->EFCBFCFEED
BAFEC->ECFEBCFAEB
EBFEA->BACDBEFAED
CFFEF->BDABACFACB
ACFBA->BDBACBAFBE
ACCEE->DCDEBDFAFB
CCDBD->FDBAEFCDCA
CEECD->EFDCADDECA
ABDFD->DCCDBAEDFA
FBABF->CACDBCAFBE
FFDEB->EAABEBFACD
CDFDD->EBCBDCEFEB
EBDDE->BFCDAEEFBF
BADBA->DABCAECDBC
DAEEC->FCFEADFABD
AFDFF->BEABEBABAC
ACAAA->BEBABCFEFB
ACACE->DCDEDBDEBF
AEDDA->BDFAFCCBFD
AAFFE->BEFEABEDAD
FDDFE->ABCBCEABBF
BDAED->CECBDCFACE
DEDAD->EADCEBFEFA
FBAFD->CACDBCEDFC
BEAAA->DADCEDFEDC
AFEEB->CFABDFDCDE
BDACC->ECEFCDBAEB
FEDFE->ADFAAEABFA
CBBBF->DACDCEAFAD
BCDBF->CDDECACDAB
DABAF->AFBCFEBCAB
DEFAB->FCDCCBFEAC
DABCA->EFBCAEBADC
ACDAD->BEBAAEBCFA
EDBCF->ABCBECBABE
AFBBD->BEABDECDBA
AFEEF->DCABDFDCCA
CACCC->DFBCFEBAEB
BBBFA->DECDEDABED
DAFFE->CABCABEDAD
EADDA->BABCEBEFBC
EFAAB->ADABFDFECF
CEEDC->DEFAFBEFEB
FADCC->CAFEFCBAEB
BBFFE->ECAFBCABDF
FFEBD->EAABBFCDAE
BFAFC->AEEDBEABDE
EFACA->CBEDBCBABC
AADFA->BEFEFAEDFB
BBCAC->ECAFDEBCBF
FABEE->BCBCFEFAFB
BFCDF->CDABEBCBDC
FEEEC->ADFAFBFAFD
BDBBD->EDEFECAFEB
ABFEA->EFCDABDCED
EFBFD->BAEDEDABFC
EDDFF->BACBFCEDEA
FFFAB->EAABACBCED
DFCFB->EFABDEABAE
BFBEC->EDABFEFADA
BFCFE->DAEDBFABFA
AFCCE->BCEDBFDEAD
FDFFE->BCEFDCEDAB
BBDEF->ECAFEBFABC
FBFCD->ABAFABDECA
BFCDD->ECEDFDCBEF
CAEAE->DFBCBFBCBA
DDAEC->FACBEDDCEF
CBCBB->EFCDAFCDCF
EAFAE->BFBCABFEAD
EDDBD->ADEFAFCDBA
BCCAE->CFBADABCBA
DDEEB->EBEFABDCFE
CFCCA->BDABDEDEFB
EBEDD->BFCDABCBFC
AACFD->DCBCAFABEB
DFDCC->EBABEBDEDF
BBCEE->ACAFFDDCBA
DBDBA->CEAFEAAFBE
CEEDC->DEFAFBEFEB
ACDDE->CFDECAEFAD
FECCA->BEFAEBDEFB
BEBED->CEDCFEFAAE
DDDBC->FACBFCAFFE
ECBBB->FADEEDCDED
DBCED->BCAFDAFAAE
EEDBA->FCFAAECDBC
DEBCE->BADCECBABF
DDEFE->AFCBDFEDAD
DCBFA->AFBAECEDBC
CAEDE->AFBCBACBDF
FAADA->CAFEBCCBFD
AEAFC->EDDCBEABDE
AAABB->DCBCDCCDED
FADDE->ADFEFACBDF
BBFFD->CEAFADABEB
EDBCA->FBEFECBADC
AAEFF->BEFEFAEDEA
CFBBB->EBEDFECDCF
BFECB->CFEDABBAEC
ADEBB->CDCBBACDED
FDEDE->BECBBACBDF
BFBDD->CEABEDEFCE
ADBAC->DCEFDABCAF
FDDAE->ADEFEBFEFA
BCAAA->CFBABCFEFB
FEEAA->CBDCADBCED
CBAED->BFCDBEDCFA
ABEFA->BEAFABEDFB
DBADB->AECDBCCBDA
FDBED->CAEFEDFACE
AABDB->EDFECDEFCF
BFBFE->ACABDEABDF
ABECF->DCCDBFDEBC
BFECA->ECEDABBADB
EDCDF->ABCBFDCBCA
BAECE->EDBCADDEDB
EAECF->ABFEBFDEBC
CADEF->DABCFADCEA
CBDDC->EFCDBAEFDE
DCDAE->BADEAEBCBA
AAEBC->EDFEABAFFE
CFFDE->BDABACEFBA
DADCE->BAFEFABABA
FEADB->CBDCDCEFDA
ACDBC->BDBAFCAFFE
ADBED->DBEFEDFACE
FFFDB->ADABACEFEC
FBDBC->CACDAECDFD
ABCAF->DCCDAFBCAB
EECFF->DBFADEABDC
ECEBA->DFBAFBCDFB
CCCCE->DFBAFDBAFC
EDBBB->FCEFCFAFCF
CDBEC->DFCBCFDCDE
FACBA->BCBCAFCDBC
BCFFD->ACDEBEABCE
DABAA->CEFEECFEDC
CFACA->DEABFDBADC
EDDAA->BACBFCFEFB
DFCAC->EFABDEBCBF
EEACF->CBDCBEBABC
EBDBA->DFAFEAAFBE
AABDD->FBFEECEFEB
BCDAC->ECBAEBFEDF
EFEFC->ADABBAEDAF
DCEFD->BCBADFEDFC
ABEAD->DCCDBFBCFA
EADBA->FBBCEBCDBC
EEFDB->FADCCBCBEC
FEDCC->ABDCFCBAEB
DCEBC->AEDEBFCDFD
EDDBF->DBEFAECDCB
FECCD->ABDCEBDECA
AFECE->FBABBFDEBF
BAFAF->CFFEABFEBE
FDDDF->ACEFCECBAC
ECBDD->FADEEDEFCE
DEBAA->AEFAEDBCDC
BDBEE->CFCBCDFACB
BCADC->ECBADCEFBD
DFCCB->FCEDBFDECF
CDCFE->DAEFFDEDAB
EFBAB->BFEDECFECD
FDDCF->CAEFEBDEAB
EBACF->ADCDDCDEAD
FBCDE->BECDBFEFAD
CCEEC->ABDEADFABD
DBFDE->BACDCBCBDF
CFAAC->FDEDBCFEAF
FBDDB->CBAFCECBCD
EBAFA->BACDFBABCD
ACBCB->FDBAEDBAEC
CADBA->EBFECACDBE
FBCBC->BECDBFCDEB
CDBCE->FECBECBABF
ECCEA->FBDEBDFACD
DCAFC->FABADBEDFD
BBFCE->EDCDBEDEDB
BEEEA->DADCDFDCBD
AAFFB->CDBCEAABDE
AFACF->BEABCDBADC
DCCCC->AFBAEBDEAF
ADEDF->DBEFBFEFCA
DBAAC->FACDFBFEDF
DCABB->EBDEBEAFCF
BDCFC->DACBEBEDBF
BECFB->FAFADEABAE
BBECB->CEAFBABAEC
CCAEF->DEDEFBFABC
BEFBF->CDFAECAFCB
BBCCF->CFAFFDBACA
AEABC->DBDCBEAFFD
DCCBE->AEDEDACDFA
CCACC->DADEBEBADA
EACBC->BFBCFDAFDE
DBDDA->EFCDCAEFDC
FCDCA->DCBAAEDEDC
ABAFF->BCAFCFABCB
FDEDD->EAEFABCBFC
AEBFA->BEDCECEDBC
DEAFE->FADCDCABDF
CCACA->EBDEFBDEBE
EBAFD->BFCDBCEDFC
CDCCD->FECBFDBAEF
CABEB->DABCECDCEC
CCDDE->DFBAFCCBBA
FDFDD->BECBDCEFEB
BBEED->CEAFBADCAE
BBEAB->CFAFABFEAC
EACFB->FCFEDFEDED
EDEED->BACBDFDCEF
FECBD->CBDCFDAFEB
EBCAC->BFCDFDFEDA
BDBDB->CECBCFCBCD
FDABC->ADEFCDCDAF
EAAAC->ADBCEDFEDA
CDBAC->ABEFCDBCBF
DDEAE->BAEFBFBCBA
CCBCE->BDBACDDEDB
ABDFE->FBCDCAEDBA
DAFCF->EAFECADEBC
ABBBF->BEAFCFAFAB
ACACC->BEBABCBADA
EEDBA->FCFAAECDBC
ECCAB->DFBADABCEC
AFAFE->DCABEDEDAB
AEFFD->BCDCCBEDAE
EDBBB->FCEFCFAFCF
EEBCB->ADFADADEED
FFEDE->CBEDBFEFBF
FFCEC->EAABDEFADA
DDFCF->BAEFCADEBC
FBDEF->CACDAEFABE
EFEEE->FAEDADFACB
EDDFC->BFEFEBABDE
BCDCE->ECBAEBDEAB
CFFDA->FDEDCBCBED
BBAFD->ECAFCDABFC
BDBBD->EDEFECAFEB
CBECA->BDAFABBADB
EAABF->DBFEBCAFBE
EBEFE->FBCDBFEDBA
CAEFB->FEBCADABAE
BDACE->CDEFBCBAFB
FAEFB->CBFEBFEDEC
AACCB->CDBCAFDECD
BADAA->ECFEAEBCBE
ABAEC->DBAFDCFAEB
DCCBC->FABAEBCDAF
DACEB->EFBCBFFAED
BDFCE->CFCBACBABA
DFCBC->EBABDECDBF
EADBC->FCFEFACDAF
CCADB->EBDEFBEFCF
AADEB->DCBCAEFAED
DDDED->EFCBCEDCFC
DBDFA->AECDAEABDB
BACCD->ECFEDADEFA
BDDED->FEEFEBFAAE
FBEEE->CACDABDCAD
AABDF->DBFECDEFBC
DEEDF->EADCBFEFCA
AFBCA->EFABEDBADB
EECFC->DFDCDEABEB
FEEEE->CBDCADFACB
CAFDD->AFBCABCBCE
BADCF->EDBCAEDEBC
EEAAF->ABDCDCBCEA
BCEDA->CDDEDBEFDC
DFBDF->EBABDECBCB
AEBEF->BEDCECDCAB
CCAEF->DEDEFBFABC
DAAAA->AFBCDCBCDC
CDBBB->DAEFCFAFCF
EAFCF->ADBCCBBADC
DCCFB->FCBAEBEDFE
DFEAB->AFABADBCAE
DAEFD->EAFEBFEDAF
FEBCE->ABDCAEBABF
CAAFB->EBFEFBABDE
CCCDF->EBDEAFEFCA
BAFAA->CDBCCBFECF
EEACF->CBDCBEBABC
ECBEE->FADEEDFABA
BDCFA->EDEFEBEDDC
ECECF->CBDEBFDEBC
FBCDF->CACDFDCBCA
FFBED->EAABDEDCFC
EACEB->FAFEDFDCED
EDAAC->FACBFDFEFD
DADDE->CABCFACBDF
CFAFE->FEABEDEDAB
CBAFF->DECDDCABCB
EFAAD->FCABCDBCAE
DBBEB->AECDCFDCDE
BFFAC->DAEDEABCBF
AEBEA->BCDCAEDCBE
BBAFB->DECDFBABDE
DFCAF->EAEDFEBCEA
FAEDE->ABFEADEFCB
FECBA->CADCEFCDFB
CFECB->DAABBFDECD
BCCAD->ECBADEBCFC
DACCD->AEBCFDBAEF
BBFEF->CDCDEAFABC
CABEC->DEBCAEDCEF
DBBEB->AECDCFDCDE
FABAF->DEFECFFEAB
BCEDF->CFBAFBEFCB
EDEBB->DFCBBFCDCF
BAABC->DEBCDCCDAF
DCBBE->FCBAECAFBF
FBCEB->ADAFFDDCEC
ADFBE->BCCBDCAFBF
BCEDE->ECBABFEFBF
CEBEA->DEFACDFAFD
AAEFB->DCBCADABAE
ECDEB->FCDEAEFAED
ECBAF->DBDECFFEAB
ABFAD->FBCDEABCFC
CACED->EFBCAFDCFA
EECDD->FCFADAEFEA
FEEBB->CBDCADCDFE
DFEDF->CEABBFEFCA
EEAFB->FCFACDABFE
EFDFE->BFEDAFABAD
ABEDC->BDAFBACBFD
DCEAC->EBDEABFEFE
FAEBB->ADFEFACDFE
DBEDC->FCAFDBEFDA
BFAFF->ACABCDABCB
FFEEC->CAEDABDCFD
FDDAE->ADEFEBFEFA
ADCAF->BECBDEBCCB
DADCF->AFBCAEDEBC
AEEDD->DCFABACBFC
ADBEE->BECBCDFACB
CFEDB->FDEDABCBEC
CFDCD->AFABEBDEFA
EABCB->BABCEDBAEC
EDFAF->ABCBCBFECA
DCDCA->EFDECADEBC
BBFED->ECAFBCFACE
FEDAC->EAFAAEBCFD
CDDEE->FECBFCDCDF
DBFBF->EAAFADAFAB
DBEFF->AECDABEDBE
FEEAB->EAFAFBBCED
CDBAF->FDCBEDBCEA
EFCFB->FAEDBFABEC
BADFD->ACFEFAEDAE
BFFEE->EDABCBDCAD
ACDAA->CDBACEFEBE
BBBFD->CFAFCFEDFA
ACEAE->DCDEBABCBF
CFDFB->FEABFCEDFE
FADBE->CBFEBACDAB
CBACD->FECDFBDEFA
FFFDA->CAEDCBCBED
FACAF->BCBCAFBCAB
CFAFF->BDABCDABCB
FDFEB->DCEFCADCEC
ADCDC->BECBDECBEB
FAADF->ACBCFBEFBC
DFCCB->FCEDBFDECF
EBDCA->BACDBADEDC
DFEFB->CEABBFEDEC
BACDF->CFFEDFCBEA
EFBAF->ABEDEDBCEA
FCBCE->BCDEEDBABA
ECAFE->BFDEDCABDF
ADAEF->BECBCDFADC
FBAFE->ADAFBCEDAD
DDBED->AEEFEDFACE
CEBFA->DAFACDABFD
CDCDC->DAEFFDCBFE
BBFBE->ACAFABAFAB
FCDFF->BCDECAEDAB
ECBCA->BFDECDDEFB
FAFAE->CAFECBFEBF
CEEEE->FEFADFDCFC
FEBAB->ADFACDBCAE
ECCED->FADEAFDCFA
DFDEF->BAEDFADCEA
CBDFB->DACDFAEDED
AFAAF->DCABEDFEBC
FEACD->CADCBEBAAE
CCBDF->BDBACDEFBC
FFDDC->CAEDFACBFD
BDCDD->FEEFDECBCE
ECCEB->BFDEDAFACD
CFEAB->FEABDFFEEC
ADDCA->BECBEBDEBE
ACDED->DCDEAFDCAE
DAFDD->EFBCCBCBFC
CDEBE->DAEFABAFDB
DFEAA->EFABBFBCBE
DAAAC->FCFEFBFEDF
CFDEC->DFEDAEFADE
FFFDA->CAEDCBCBED
FFBCD->CAEDCFBAAE
ABDEA->BEAFEADCFB
CECBF->EBDCEBCDBE
CBAFB->EFCDFBABDE
CBCBB->EFCDAFCDCF
ECFAA->BFDEBCBCDC
FAADE->BCBCDCEFCB
FDDCD->EAEFEABAFC
FCEDB->CBBABACBEC
EFDAE->FBABAEBCBA
BAFCA->ECFEBCDEFB
FFFBC->EAABACAFEB
DEBDC->FCDCAECBFE
AFFEE->DCABCBDCAD
EEBFE->FBFACFEDAB
DCFAF->EABACBFECA
BCFDC->DADEBECBEB
AAEAF->DBFEABFECA
BEACA->EDFAEDBACD
FAADE->BCBCDCEFCB
AFADC->DCABEDCBDE
AECED->DBDCEFDCAE
ECEBA->DFBAFBCDFB
ABDEC->DCCDBADCEF
BFCCD->CFEDFDBAEF
EEDDB->BFDCFACBEC
EAFCE->ABFECADEBF
BEDCD->EDFACEBAAE
FDEDA->ECEFADEFDB
BEBDF->CDFADACBDC
EFFDF->ADABDCEFCA
CFFFB->EBEDEAABDE
ACCFA->CDBAEBEDDC
BDBCE->EDEFECBABF
AEFAD->BEDCABFECA
EAECD->FAFEFADECA
BEFED->EDFADCDCFA
EAEFF->DBFEBAEDBE
AABBD->DBFECDCDCA
AFFBF->BEABACAFAD
CFADA->DAABCDCBFD
ABFEF->BCAFBEFADC
BFCDD->ECEDFDCBEF
FEFCF->ADFABCDEBE
EDDFA->DFCBEBABCD
ABFBA->DBAFCBAFBE
FBADB->CACDBCCBDA
ECFAF->ADDEBEBCCB
DFDEB->CEABEBFACD
AEBAB->FDFAEDBCFE
DBDDC->FACDBAEFDE
FACBC->CAFEFDAFDE
BEADD->CEDCDCEFAF
EDBCF->ABCBECBABE
ACEFB->FDBABFEDEC
DDCAE->AEEFDEBCDF
FEFCE->CADCABDEDB
FCBCD->CBBAECBAEB
FBAFA->CBAFBEABCD
FECFA->DCDCEFEDDC
CEDFF->DEFAAEABAD
CBAFF->DECDDCABCB
BCDDB->CDDECAEFCD
ECEFA->BFDEBFEDBE
EEDEF->BADCAEFABE
DECEE->CAFADEFAFB
ADAEA->BCCBFDFACF
AAFDC->BEFEABCBEB
BCDEE->ACDECAFABF
CFBFF->EBEDFEABAD
EDBAD->ABCBECFEAE
EFBAE->CDEDECFEAB
AFFFA->CDABCBEDFB
EEDDF->ABDCAEEFCA
ADEAD->BECBBFBCFA
BBEEF->CFAFABDCEA
ADBBC->EDCBCDCDBF
BFDFB->FAEDAFABED
CADAB->DABCFAFEED
DCDAE->BADEAEBCBA
EDDEB->BFEFEBFACD
BDBFB->FAEFCDABAE
DFAFE->AFABDCABDF
EEAFA->BFDCBEABCD
DFABD->AEABDBAFAE
FDFBA->BCEFDCAFCD
CAADC->DEBCEDCBDE
BAAAC->DABCDCBCAF
ECEFA->BFDEBFEDBE
ACAED->DBDEDCFACE
DEEBC->FADCADCDBF
DEDCF->EADCEBDEAB
EFACA->CBEDBCBABC
DECCA->FCDCEBDEFB
BDCBE->DACBEBCDBF
EEEFF->BADCADABDC
EFDDA->DFEDFCCBFD
FFACF->ADABCDBADC
DAECF->CEFEFADEBE
EABBF->CBFECDCDEA
BCBCA->ECBAEDBADB
AEECD->FBFAFBDEAF
BFBEA->CFEDCFDCBD
DABEA->AEBCECDCBE
ACDDB->EDBAEFCBDA
BEDAF->CFDCEFBCCB
BCBDF->ACDEEDEFCB
CCBFA->FEBAECEDBC
BCCDC->FEDEDAEFFD
DBDEA->EBCDAEFACF
CDCFF->DECBEBEDEA
EBBCB->FACDFEDECD
AFABD->DBEDBCAFBA
CADEA->DEBCFCDCED
DDACB->FCCBFDBAED
FCFBB->CADEBCCDED
DABEB->EBFEECDCEC
CCBFD->FDBADEABFC
DAFFE->CABCABEDAD
EADEC->DFFEFADCFD
DFDAB->EFABEBFEEC
AAADB->FDFEBCCBDA
FCBCA->CADECDDEFB
DECBF->EADCDACDAD
EACBD->FCFEDFAFCE
CFACB->FEABEDBADE
BDDFC->ECEFEBABDE
DEEDC->EFDCDFCBDE
ACCEA->BDBAFDDCBE
BFFFF->EDABCBEDBE
EBFCF->ABAFBEDEBE
FFEAB->CBEDBFBCEC
BABFD->FEBCECEDFA
DCAEB->CEBABCDCAE
AECDA->CDFAEBCBFD
BBDEE->DACDCAFABF
CBFAC->ABAFADFEDF
EADEF->DBFEFCDCCB
BAAFF->EDBCDCABCB
ADDEB->DBEFEBFACD
FFEAF->ADABBFBCAB
EDFFA->BFEFCAEDBC
AAFCA->DBFEBCDEFB
FFCBC->ADABDECDBF
DEFAF->AFDCEABCCB
CFCBE->FEABFDAFBF
BFCEC->DEABFDDCEF
CABBC->DFBCEDCDAF
AEADD->CFDCEDCBEB
FAFBA->ECFECBAFBE
FCCCD->EADEDFBAFC
CEBCC->FDDCECBADE
ADDBA->BCCBCEAFBC
DDDEC->EBEFEADCDA
BCBDF->ACDEEDEFCB
CCAFE->FDBACDABDF
CCFCC->FDBACADEDA
AABAB->CFBCAEFECF
CADBB->FDFEAECDCF
FACFF->ACBCFEABCB
EECFD->ADFABDABEB
FEADD->BEFAEDCBEB
ACFCF->DCDEADBABC
AEDDC->BEDCFACBFD
EEBAA->BFDCECFEDC
EFABB->DFEDDCCDED
DCBDE->AFBAECEFBF
CEDFD->FDDCFAEDAE
ECFBE->CDBABECDAD
BCDCC->DEBACEBADA
ACEFA->DBDEBFEDBE
EAFCB->FCFEABDEED
CFBAA->EBEDFEBCBE
CCAEF->DEDEFBFABC
FFDDD->ADABEBEFEA
DCCDC->EFDEAFEFDE
CBCED->FECDAFDCFA
CBBCA->DACDCEBABE
DFBAD->EFABDEBCAE
CEFFA->EBDCCBEDFB
ABFAC->DCCDBEBCBF
ACADD->BEBABCCBCE
BBEFE->DACDADABBA
ADFDD->CFCBDCEFEB
BEBCE->CDFADADEDB
DECEC->FCDCEBDCEB
FEABE->ABDCEDAFBF
EDACC->BFEFCDBAEB
EFECD->BAEDBFDEAE
DDCEC->AEEFDEFADA
FEEDF->ACFADFCBAC
FEADC->EAFACDCBEB
CBBAE->DACDCEBCBF
DEAEE->FCDCEDDCBA
BCCBF->CFBADACDAD
ABEED->CFCDADFAAF
EDBAF->BFEFEDBCEA
EABDA->FCFEECEFCD
DCBBC->AFBAECAFDE
AECDE->BCDCEBCBBA
AFBCF->BCEDFEDEBC
EFBCB->DFEDFEDECD
EFFFB->ADABDCEDCF
DBBAF->BACDCFFEAB
FAACD->EABCEDBAEF
EBAEC->BFCDBCDCEB
FFBCD->CAEDCFBAAE
AEFDB->EDDCABCBDA
BDCDA->DACBEBCBFD
BFCAF->DAEDBFBCAD
FAFEB->ACBCBEFAEC
BEEEA->DADCDFDCBD
EFAAB->ADABFDFECF
EFCED->ADABEBDCFC
DBAAE->AECDBCFEAD
FEBFD->EAFACDABCE
FFEBF->CAEDABAFBE
AEAFA->DBDCBEABCD
EEDBF->BFDCFACDBE
CECAC->ABFADEBCBF
FFBAB->CAEDCFFEEC
ECCFF->BABAEBEDEA
BCBCE->ACDEEDBABA
CDFAC->DAEFBCBCAF
EFCAB->FCABDEBCAE
EEBAA->BFDCECFEDC
AEEAB->CDFABABCED
ABCBD->DBAFDACDFA
BCCDB->CFBADAEFCF
CDEDC->ABEFADEFBD
ADEDA->BECBBFEFCD
DDDFB->FCCBCEABDE
CAEBF->EBFEADCDEA
BFECD->EDABDFBAAE
FFFCF->CAEDCBBADC
DACDA->EFBCBFEFDC
DCDBB->CEBAAECDCF
EFDFD->ADABCEABEB
FBDFC->ABAFEAEDFE
CFFBA->DEABDCAFCD
DBDDE->AECDAEEFBF
BDADE->CFCBCDCBBA
EEBFA->FCFACDABFD
ADFDA->BCCBDCEFCD
BFEBF->ECEDABAFBE
CADFE->DFBCEBABBF
FDEEB->ADEFBFDCEC
BCDAF->EDBACEFEAB
CEFDD->EFDCEAEFEA
FDAAC->ABCBFDFEFD
BDCFF->CDEFFDEDCB
EBEDA->BACDBFEFCD
CAEFD->EBFEADABCE
BDCCA->ECEFDEDEFB
EDCBC->BACBFDAFDE
CFAAD->BFABDBFEAE
ADDBC->FBEFEAAFEB
FAABE->CAFEBCAFDB
BFDBB->CFEDFACDED
ECCEA->FBDEBDFACD
DCAEE->CADEBCDCDF
FFCED->BEABEBDCFC
BBDEA->CFAFEADCFB
DEDFE->CAFAEBABBF
AFFFD->BEABACABAE
DDABA->FCCBFDAFDC
CBBFF->FECDEDABCB
CAAFC->FDFEDCABFD
CAEAC->ABFEBABCFE
DCAFD->EABABEABEB
BCCFD->CFBADAABEB
CADFA->DABCFAEDFB
FFFAC->BEABDCFEDA
DFACE->AEABDBDEBF
CEEEE->FEFADFDCFC
DCFDE->CADECBCBDF
DBBCE->FCAFACDEDB
ABABD->FBCDDCCDBA
FCABE->BCDEFBCDAD
CFBCB->EFEDFEDECD
CABFA->EBFEEDABED
EECAA->FCFADABCBE
DBCBE->CACDEBCDBF
BDFBE->CDEFBCCDBF
EBCBA->BACDAFCDBC
ABFCE->DCCDBEDEDB
CEACE->DAFACDBABA
ACFDD->DBDEBCEFAF
FBBFF->DEAFCDABDC
BFCFF->ECEDFDEDCB
CFDEB->EFEDFCDCAE
FCBFE->ADBACDABBA
DEDEF->AFDCAEFABE
DDBEE->CAEFCDFACB
CEFCB->FEFACBBAEC
CEBAE->BDFACDBCDF
DFDFA->EFABEBABCD
DBEDD->AECDABCBFC
DCAAF->AEDEDCBCEA
DEBED->EADCEDFACE
ACFDC->BDBACBCBFD
AEAFB->FDFACFABFE
EDDFC->BFEFEBABDE
BFCDF->CDABEBCBDC
CBDAF->BDAFEAFECA
CDEAA->BDCBBABCFB
ADBEA->EFEFCDFAFD
BBFBF->DACDEACDAD
BFAEC->FEABDBDCEF
FECAB->DCDCEFBCFE
DDABA->FCCBFDAFDC
CEADD->EBDCEDCBEB
CFBCC->DFEDEDBAEB
BBEFA->CFAFABEDFB
EBBFC->BFCDCFEDFD
EFDFF->DBEDAFABEA
FCAEC->BEDEFBFADA
DEBFA->EBFACDABFD
FFEDD->ABEDADEFAF
BEDAD->CEDCAEBCFA
BDEFE->EDEFBAEDBF
CBBEE->FECDEDFABA
ECFBA->FBDEADAFBC
AFBBA->CDABFECDBC
FDABF->BCEFDBAFCB
BCBCB->CFBACDDEED
DBEEB->AFCDBFDCEC
FDDBE->CAEFEBCDAB
AFEEF->DCABDFDCCA
CDDEA->EBCBCEDCED
FBAAF->ADAFBCFEBE
CCCCF->FDBAFEBADC
DADEC->FAFECAFADE
BBCEC->FECDFDDCEF
CCEBA->BDBAFBCDFB
AECFA->BCDCEBEDDC
BEBEE->ECDCECDCBA
BFBFC->FEABECEDFD
EFDFD->ADABCEABEB
BCDCE->ECBAEBDEAB
AADEC->FBFEFADCFD
DFCDF->BAEDFDCBCA
ADEDC->DCEFCBEFDE
EADAB->FCFEFAFEED
DCAEA->AFBADBDCBE
AAFDA->BDBCBECBFD
BDEFC->AECBFCABDE
EAFFA->BABCBEABFD
ECCFD->FCDEDAABEB
FCEED->EADEABDCAE
BBBFD->CFAFCFEDFA
FADDC->BEBCFCCBEB
BAEAA->CFFEFAFEBE
AFBFE->FBABDEABDF
BBAEE->CDCDDCFABA
DADAD->BCFEFCFECA
EAFFD->BFBCABEDFC
FEDAA->DCDCFAFEFB
DDEAD->EBEFABFEBA
FADBB->CAFEFCAFAC
BFFCB->CDABDCBACD
BDDCF->ECEFEBDEAB
FDCDC->ADEFDECBEB
AEADB->DCFAEDCBCD
EFDAC->BAEDAEBCFD
FCDAA->BCDECABCBE
BAAFF->EDBCDCABCB
BCDDA->CFBAAEEFCD
CDCDE->FECBFDCBFC
CABEE->BDFEECDCBA
EADCE->FAFEFABABA
CAAFB->EBFEFBABDE
ACEEC->DCDEBADCFD
FFDBC->ABEDFCAFFE
EDEDD->ABCBDFCBEB
BBBBD->CEAFECAFEB
FBCDE->BECDBFEFAD
FFACF->ADABCDBADC
EADDC->ADBCFCCBEB
EBFEF->CBAFABDCCB
EEDFA->BADCAEABDB
ECBAE->BFDECDBCDF
CDACC->FDCBCFDEAF
EEFCF->DBFABEDEBE
CBCBA->FECDAFCDBC
AFDFE->DBEDFAEDBF
ADADE->BECBCDCBBA
DBCAD->EBCDFDFEAE
EEDAF->DBFAEBFEAB
DEEBC->FADCADCDBF
DFBBF->AFABEDCDBE
DECAC->AFDCFDFEDA
DBFCA->FCAFBEDEFB
BBBFF->EDCDEDABCB
DCAFD->EABABEABEB
ABFAA->BEAFABFEFB
AAACC->DCBCDCDEBD
EEECE->FBFADFBAFB
EFAFF->ABEDFBABAC
AACBA->CDBCAFCDBC
CBECB->EBCDBFDECD
BCBEB->CEBACFDCDE
DCEEA->EBDEABDCDC
DFACD->EAEDCFDECA
EEEBB->BADCADCDFE
DFDCE->AFABAEDEBF
DDEAE->BAEFBFBCBA
CEDAB->FEFAFCFEED
EFFBE->BFEDABAFAB
BFCDF->CDABEBCBDC
CBCAA->BDAFFDFEDC
DEBCC->AEFAEDBAEB
ADACD->BECBCDBACE
DEABF->AFDCDCCDBE
ABDAA->BDAFCEFEBE
DFDAC->AFABAEBCFD
FFFFB->ACABEAABDE
FADFA->ECFEFCEDDC
ABCBD->DBAFDACDFA
EFDEE->FCABEBFAFB
ACCCE->CFDEAFDEBF
EBBBB->BACDEDCDED
AABDA->BEFEECEFCD
EBDAE->CDAFAEBCBA
CFEEF->FEABDFDCCA
DDCEE->BAEFDEFAFB
FAEFF->ADFEFAEDEA
EABFC->FCFEECEDFD
FBCFE->CBAFEBEDAD
DFFDA->AEABADEFCD
CEFCF->DAFABCDEBE
EBCEB->FCAFFDDCEC
AACFB->FDFEFDEDCF
DAFAF->EBFEABFEBE
EDDCC->BACBFCBAEB
EEADB->BADCDCEFDA
ABDFB->FDAFAEABEC
ABCCC->FBCDBFDEFD
AABFF->CDBCFEABAD
EDEEA->BFEFBFDCBE
BBFBD->EDCDBECDCA
CCBAC->EFBAECFEDA
ECEEE->FBDEBADCAD
BEACF->CDFAFDBABE
EBADE->CDAFDCEFCB
FABEA->CAFECFDCBD
DBEAD->BCAFADBCFC
DFFCA->EBABACBADB
FEBEC->EAFACDFABD
CBAFC->DFAFBEABDE
BDDBE->ECEFEBCDAB
CAEFF->DABCBAEDBE
CABAF->FEBCFEBCAB
DFFBF->EBABACAFAD
BDBDE->CDEFCFCBBF
ACFBF->CDBADCAFBC
EEAEC->BADCDCFAEB
AAFEC->DBFEBCFAEB
ABEEF->BEAFABDCEA
AAACB->EDFEDCDEDA
CCEEB->DEDEDBFAED
BECFE->ECDCEFEDAD
CFCDB->EFEDBFEFCD
DFBFD->BCEDECEDFA
CDCAE->FDCBFEBCAD
AFBEC->DCABFEFADA
FABAD->ADFEECFEAE
FAEDB->ACBCBFEFED
FBFCA->BECDEADEBE
DDAAE->FACBEDFEAB
DDDDB->EBEFEACBCF
FECDE->ABDCEBCBBA
BADAE->ACFEFAFEAD
AEACD->DBDCBEBAAE
ACBBF->DBDECDCDEA
ADCCA->DBEFDEDEFB
ECDAB->ADDECABCEC
BDAFE->DACBFDEDBA
DAAFA->CEFEBEABCD
DBFAD->FACDBEBCFC
DDCAB->AFCBFDFECD
EFAED->BAEDFBFAAE
CAFEE->AFBCABDCDF
AACAB->DBFEDABCEC
CFAAE->AFABCDBCAD
FABEA->CAFECFDCBD
BACBF->EDBCAFCDCB
CEBCF->FEFACFBABC
AFAFA->BDABDCABED
BFAFC->AEEDBEABDE
CFAAB->EBEDDCBCFE
FFCAD->CBEDAFBCFA
DBBEA->FCAFACFACD
DFDBB->EBABEBCDCF
BAEAF->ECFEABFECA
DCBDB->AEDECDEFCF
BCFCB->CEBACBBAEC
FDFFE->BCEFDCEDAB
DDBCE->AFCBECBABF
EDCFA->BACBFDEDBC
FADAF->ACBCEBFEAB
ACABE->FBDEBEAFAB
DABFC->EBFEECEDFD
ADDBC->FBEFEAAFEB
BBFAE->DACDEABCDF
FABFC->ADFEECEDFD
AAFDA->BDBCBECBFD
AEDFD->DBDCFAEDAE
ECBDE->CDBAEDEFBA
FABFA->BEBCAEEDBE
BABAF->EDBCFEBCAB
CFCBE->FEABFDAFBF
DFDCD->EFABEBDEFA
FAFFA->CBFECAEDBC
CCABE->BDBABCAFDB
ABCAD->BEAFFDFEAE
BEEBD->CEDCADCDCA
DEDDA->FCDCFCCBFD
BFBFB->CFEDCFEDCF
AEEAC->BDFADFFEDF
FEAAC->ADFACDBCAF
BCFEB->FADECBDCFE
DACFD->BCFEFDEDFA
FEFBE->ADFABCCDBF
CFBCF->DEABAEBABE
ECEFC->FADEDBEDEB
DEAEB->EFDCEDDCEC
AAAFC->DBFEDCABFD
AFCEC->FBABDEFADA
AFCDE->BEABDECBBA
ADBDF->DCEFDACBDC
DBFCB->AECDCBBAEC
DFEDC->EBABBFEFDE
AEBAF->CFDCAEFECB
ECDDF->BFDEAEEFCA
FFCEC->EAABDEFADA
AFBCC->BDABEDBAEB
AAFFA->EFBCADABCD
BFACB->FAEDBEBACD
CFFEE->FEABCBDCAD
DDCCD->BCEFDADEFA
EEDAA->CBDCFAFEFB
FDDAB->EAEFEAFEAC
EBBFC->BFCDCFEDFD
BDCEB->CECBDAFACD
CAAAB->EFBCDCBCFE
BEBCF->EDFAECBABE
CBCCD->EBCDAFDEAE
DCBBC->AFBAECAFDE
DCAEC->FCBADBDCEF
CAAAD->FDFEDCBCAE
DFCAB->EBABDEBCAE
EBDDE->BFCDAEEFBF
EAEFB->BABCBFEDEC
FFEEF->DEEDBADCEA
FCCFD->ADBADAABEB
EEFAD->FCFABCBCAE
ABAAE->DBAFDCBCAD
AACBF->DCBCAFCDCB
DAFBF->AEBCABAFAB
FEDDC->ADFAAEEFDE
DFFEA->FCEDEAFACD
BFCCE->CDABEBDEDB
CFDAB->DEABCEFEEC
CBCCC->EFCDAFDEDA
AEECA->BEDCBABADB
DCECF->BADEBFDEBC
ADCEB->CFCBEBDCAE
FFEBF->CAEDABAFBE
DFCFF->AEABEFEDEA
CDBBE->BDCBDACDAD
DCDEE->FABACEDCDF
EEBBD->FADCAEAFAE
FAFBE->BEBCCBAFBA
BFBAD->FEABECFEAE
AEDEE->BCDCFCDCDF
ECBCD->BABAECBAEB
DFBAA->FCEDFEBCBE
EBBFE->FACDFEABFA
CBBBC->EFCDEDCDAF
FBFAA->ECAFCBFECF
CDBBB->DAEFCFAFCF
FDBAA->ECEFCDBCED
BCCEB->ECBADEFACD
FBBFC->CACDCFEDFD
CCBEF->FEBAECDCAB
DBADE->AFCDFBEFAB
BCDFF->ACDECAEDAB
FCEDF->ADBAFBEFCB
EAEBA->BFBCBACDFB
CFEBD->EFEDADCDCA
ABDCD->DBAFAEDEAE
BDEFC->AECBFCABDE
EEBDB->DFDCDECBEC
DDAAF->EACBDCBCEA
FADED->BEBCFCDCFC
CDEEF->EBCBBADCEA
CCAFF->DADEBEABAC
CDEFC->DAEFABEDAF
CEDBA->DAFAAECDBC
DBFDA->CEAFABCBFD
CEACB->EFDCDCDEDA
EDBBB->FCEFCFAFCF
ECFCA->DFBABCDEFB
ADBDD->BECBCDEFEA
ADEAB->CFCBBABCED
DDDBD->EACBAECDAE
AFCEA->BCEDBFFACF
EBDDC->DFAFEACBDA
FABDA->ECFECFCBCD
EDFAE->CDCBEABCDF
FDCEC->CAEFDEFADA
BEFBA->EDFADCAFCD
BEECB->CDFACBDECD
DAADB->EBFEBECBCD
EDBDC->BFEFEDEFEB
CEACD->FDDCBEBAAE
ABAFC->BDAFBEABDE
CDBEC->DFCBCFDCDE
BADBA->DABCAECDBC
DDDFE->BAEFEBABBF
ADEFF->CDCBBAEDBE
CCDFB->FDBAEFABDE
EAEEE->FCFEFADCDF
EABCB->BABCEDBAEC
DBFFC->FACDBEABEB
DDEFD->EFCBBAEDAE
FEAFA->CADCBEABCD
CABBA->FEBCFECDBC
FAAAB->EABCEDFECD
DDDED->EFCBCEDCFC
BFBFA->ECEDCFEDBC
ACADD->BEBABCCBCE
BEAAE->EDFAEDFEAB
FDAEC->EAEFBCDCEB
EBBDF->ADCDFEEFCA
FFCCF->DEEDEBDEBE
BEAAB->ECDCBEFEEC
EDFAA->FBEFCBFECF
AAADD->DCBCDCEFAF
BAEEA->EDBCADFAFD
BEFFE->EDFADCEDAB
DDEDF->AEEFBFEFCA
EDEFF->ABCBDFEDEA
CAFEB->EBFEBEFAEC
CEEEC->DAFAFBFAFD
DAEAF->AEBCBABCBE
ACEFC->EDBAFCABDE
FACED->EABCBFFAEB
CABDD->EFBCFEEFEB
AAEEE->BEFEFADCDF
BFEBC->EDABDFAFFD
FEAFD->CBDCDCABFC
BBFEF->CDCDEAFABC
CCCDA->FDBAFECBED
FDAAB->ADEFCDBCFE
ECFEC->DFBABCFAEB
FCFBB->CADEBCCDED
BDAFF->ECEFCDABCB
CBDAE->FECDBAFEFA
FADBC->ADFEFACDAF
DEDFA->AFDCAEABDB
CFADE->DFEDFBEFAB
AAABC->FBFEBEAFFD
EFDFA->CBEDFAEDFB
BDEBC->DACBBACDAF
EFAAB->ADABFDFECF
CBCCE->FDAFDEDEDB
EADFF->BFBCFAEDBE
CADEA->DEBCFCDCED
DBEFA->EBCDABEDFB
DBBEF->CEAFCFDCCA
CBFFE->FDAFBCABDF
FDDCC->CBCBFCBAEB
CCEBE->AFDEBFCDAB
ABAAD->CFCDDCBCAE
BACFD->EDBCAFABEB
DBEAE->FACDBFBCBA
DDBEC->FCCBDADCEB
ECCCB->FADEAFDECD
DDADE->CAEFDCEFCB
AAFBE->CFBCCBAFBA
EBFAB->FACDEABCAE
CBDFB->DACDFAEDED
DECEF->BADCEFDCEA
AABBE->BEFEECAFBF
CFBAF->BDABDEBCEA
CADCB->EBFECADECF
AABAE->BCFEEDBCAD
FAECD->ABFEADDECA
BDECE->ECEFBFDEBF
AEFED->DCFADCDCFA
EACFC->FAFEDFEDAF
FDDBE->CAEFEBCDAB
AEEED->BCDCDFDCEF
DFACA->EFABCDBADB
BFCBE->EDABFDAFBF
FEFDB->DCDCABCBDA
EDFEA->FCEFBCFAED
FEDDF->BCFACECBAC
BAFFB->DEBCEAABDE
BDFEB->CDEFBCFAEC
BFCAE->ACABDEBCDF
BAEDE->CDBCDFCBBF
ECDBB->DFBAAECDCF
AEEEE->DCFABADCAD
CFAEC->DEABFDFADE
DCFDC->FCBADCEFDE
EFDFB->BAEDAEABEC
BDBBE->ACEFCFAFAB
FAEBE->BCBCADCDAD
BBAAB->FACDBEFEEC
FEEAE->ADFAFBBCBF
AFEED->BEABBFDCFA
BADFB->CDBCFCEDFE
FEEBB->CBDCADCDFE
EEACD->BFDCBEBAAE
BFAEB->CFEDBCDCAE
DEFDC->AFDCEAEFFD
CABFE->FEBCFEABFA
BAAAF->CDBCEDFEBC
DFDFA->EFABEBABCD
CFCAB->DAABDEBCAE
DCDBE->CADEFCAFDB
BCECD->ECBABFDEAE
BDEEF->DACBBADCEA
DEAEB->EFDCEDDCEC
CDFFF->EBCBDCEDCB
ADFEF->DBEFCADCAB
BCBFB->DEBAECEDCF
BEEFE->CDFACBEDAB
FFFCB->DCEDCBBAEC
DBAEE->BACDBCDCDF
BCCFA->DEBAEBEDDC
FBECF->DEAFADDEBE
DBECE->BACDABBABA
ECCEA->FBDEBDFACD
ECABF->ADDEFBCDEA
AAAFD->BEFEBEABEB
BADFA->CFFEFAEDFB
FFFEC->ADABACFAFD
EFAED->BAEDFBFAAE
DFFBF->EBABACAFAD
ABFAA->BEAFABFEFB
AFABE->BEABCDCDBF
BCFFB->CDDEBEABAE
BFFDC->FEABADEFDE
EEDCB->FCFAAEDECD
EAEFD->ADBCDFEDFC
DBAAA->EFCDDCBCDC
FECFF->ADFADAABAC
FAFCE->BCBCEADEAB
AACFE->FBFEDFEDBF
AFFFD->BEABACABAE
FBCCB->CBAFEBDEED
FFFAD->CAEDCBFEBA
DEABD->EBFACDCDBA
ADBCD->BCCBDADECA
ABAAD->CFCDDCBCAE
EAFEE->FAFEABDCDF
EEBBD->FADCAEAFAE
FBBEC->ADAFCFDCDE
DBFCE->AFCDBEDEDB
FAFFE->ADFEABEDAD
FFDFD->BEABCEABEB
CCADE->AFDEDCEFCB
ABAEA->CDCDFBFACD
EBCEF->ADCDBFFABE
EEEFF->BADCADABDC
AAAFC->DBFEDCABFD
FBDAE->CBAFCEFEFA
ABBBF->BEAFCFAFAB
DAEED->AEBCBADCAE
CCADF->FEBADBEFCA
DFAFC->EBABCDABFD
EAFEC->BFBCABDCEB
CCFFF->FDBACAEDCB
DBBDB->EBCDCFCBCD
EFCDA->BAEDAFEFCD
ACDEE->FBDEFADCAD
BBABC->EDCDFBCDBF
CFBBD->BFABECAFEB
CFDFB->FEABFCEDFE
DEECF->AEFABFDEBC
EAEDF->BABCBFEFCA
FFBFA->CAEDCFEDBC
AACEE->CFBCBFFABF
CEFFA->EBDCCBEDFB
BAEDC->ECFEABCBFD
ECEAE->CDBABFBCBA
BBCCA->CDCDBFDEBC
FFEBE->BEABBACDBF
CEBEB->FEFACFDCDE
FAADA->CAFEBCCBFD
BEFBD->ECDCABAFEA
DFCFC->AFABDAABDE
ADFFC->EDCBACABDA
CCFAF->EBDEBEBCCB
FBCEF->ACAFEBDCCB
DCDFA->FCBACEABCD
AAFEC->DBFEBCFAEB
EDBBF->ADEFDACDEA
CBFCE->FECDBEDEDB
AFCBE->DCABFDAFBF
BFAFF->ACABCDABCB
BDBCB->ECEFEDBAEC
FFEEE->ABEDADFACB
AACEE->CFBCBFFABF
EBBFF->BACDEDABCB
ECBCF->ADDEEDBADC
DFCEF->EBABDEFABC
AEABD->BEDCBEAFEA
BDFCF->CDEFBCDEBE
DACAB->AEBCFDFECD
DBACA->AECDBCBABC
AEFDD->FBFABCEFAF
DDAEA->EFCBFDFACF
CEAEB->DEFACDFAEC
CAEED->FDFEABDCAE
ECDCC->DFBAAEDEDA
BECED->ECDCEFDCAE
ABBFF->DCCDEDABCB
EAAEF->ABFECFDCCB
ADBBD->DCEFDACDCA
DADBF->CEFEFACDBE
FEEEE->CBDCADFACB
FEFDE->BEFADCEFBF
ADFAF->CDCBDCFEBC
AEDCB->FDFAEBDEEC
ACEAE->DCDEBABCBF
BEFEE->ACFABCFABA
FFCFE->BEABEBEDAD
CFACB->FEABEDBADE
CEEAD->FDDCBABCEB
EEBBC->FCFACDCDBF
EEBDA->BADCFEEFCD
FEBCB->ACFACFBACD
DCECB->CEBAFBDEDA
DFCBE->AFABDACDFA
ECCBB->BABAEBCDED
DDFBF->AFCBCBAFAD
BFBBA->DEABFECDBC
ABEBD->BCAFDBCDAE
CCBFA->FEBAECEDBC
CEABD->BFFACFCDCA
AFFEA->BDABEAFACD
FBEED->BECDADFAAF
CFAEC->DEABFDFADE
BCEFD->EDBABAEDAE
ACEDB->DCDEBACBEC
FDCCB->ADEFDEDEED
DACAB->AEBCFDFECD
BCFCB->CEBACBBAEC
FFEBB->DCEDABAFAC
EBAAA->CBAFBCFEFB
ACDFF->CDBACEABAC
FCFBD->ABDEBECDCA
BEDEC->ECDCFADCFD
AACAD->BCFEAFBCFA
BDACA->DECBEDBACD
CBDFB->DACDFAEDED
ADFDF->BECBACEFCB
EECAA->FCFADABCBE
CFFBE->FDEDCBAFBA
FBADB->CACDBCCBDA
EAAEF->ABFECFDCCB
BCDBE->CFBAAECDAB
DFFDE->FAEDBECBBA
FDBAD->EAEFCFFEFA
FEDAB->CBDCAEBCEC
DDDDF->EACBAEEFCA
FDDCB->DCEFEBDEEC
DDCBC->AFCBFDAFDE
FDECB->CBCBDFBACD
CAEBA->FDFEABAFCF
CEBBE->FEFACFAFAB
FAAEC->ADFEBEDCEF
CEDFC->DFDCEBABDE
DDCAB->AFCBFDFECD
BBAAC->DECDFBFEDF
CFDBB->DAABEBCDCF
EFECE->ABEDBFDEBF
CAFAD->EBFEBEBCFC
FEDFF->ABDCFCEDEA
CAFDB->FDFEBCEFDA
CEFEA->FDDCABDCED
ECAEB->DFBABCDCAE
CEFCE->FDDCABDEDB
BCEBF->EDBABACDBE
ECECC->ADDEDBDEFD
EDAEC->DFCBCDFAEB
CEFEF->EBDCCBDCEA
DDCBB->EFCBEBCDED
AFAFD->BCEDDCABFC
BAAEF->ACFEBEDCAB
EEBFD->ABDCFEABAF
DEBBD->EFDCAEAFAE
EDECF->DBEFADDEBE
DEDDD->EFDCFCCBCE
EDCEA->DFCBDEFACD
ACEFD->DCDEBAEDAE
FCFBD->ABDEBECDCA
BCDBF->CDDECACDAB
DBAED->EBCDBCDCFC
CCEDD->EBDEDBEFAE
FBDCD->CACDAEDEAE
ADCBE->CFCBEBCDBF
ECFDE->FCDEBCEFCB
BECAA->CFDCDEBCED
BEDFC->DADCFCEDBF
FEEDB->ADFAFBEFEC
DDBED->AEEFEDFACE
CCCCC->ABDEFDBAFE
DFECD->BCEDBABACE
FEEDB->ADFAFBEFEC
BCEDD->CEBADFCBEB
CCBBF->FDBADECDBE
DDFAF->CECBACBCBE
AFCAC->EDEDFDFEDA
DACCC->FCFEAFDEDA
AEDCE->FBFAAEDEBF
CEAAF->BDFACDBCEA
FACBB->ACBCFECDED
ACEAF->CDBABABCBE
DCBBE->FCBAECAFBF
FBBEF->BCCDEDFADC
DFDFF->EBABEBABAC
CAADE->BDFEBECBBF
BFBEB->CDABAEDCEC
EAFEA->DFFEABDCED
EDFCC->ADEFDCBADA
ECCFA->DFBADAABCD
CCADD->BFDEBCCBCE
ABCCA->BCAFFEBADB
EEAEC->BADCDCFAEB
DDFFB->EBEFBCABFE
EFDFD->ADABCEABEB
DEABB->FCDCEDAFED
EDCDE->CDCBDAEFAB
AEDDA->BDFAFCCBFD
BCCBD->CEBAFDAFEB
FFCDC->BEABEBCBEB
ABFAF->DBAFCBFECA
DFCEB->AFABDAFACD
DBACD->BCAFDCDEAF
CDDFB->EBCBCEABDE
BEEAF->CDFACBFEBC
AAEFD->CFBCDFEDFC
ECCEA->FBDEBDFACD
BFDAA->CFEDFAFEFB
ADDBF->BECBEBCDCB
FFFFA->BCABCBEDFB
BEFCA->CDFAECDEDC
DFEEF->AFABADFAEC
DFFEB->AEABADFACD
DFCDC->FCEDBFEFDA
BBCAD->CFAFFDFEAE
EFDAB->FAEDFCFEED
AAFCD->DCBCEADEFA
ABAEE->BCAFCFDCDF
CAFBE->DFBCBECDAD
EACAC->FCFEDFBCFE
DDDBF->EBEFEAAFAD
ADBAB->EDCBCDBCAE
EEACD->BFDCBEBAAE
EDBCA->FBEFECBADC
DBAFE->CACDBEABBF
BCBFD->ECBAEDABFC
FBFED->CACDCBDCAE
FBAEB->ACAFBEDCEC
DBFDD->EBCDCBCBFC
EFBEA->FCABDEDCED
AEDCF->CFDCFCBADC
FDAAE->BCEFDBFEAB
BBDBA->DECDBACDBC
ADBDF->DCEFDACBDC
FCBDC->ADBACDEFFD
CEEFA->BDFAFBABDC
AFDAB->EDEDFAFEED
ABBBE->DBAFCDCDAD
DCFAB->EBDEABFEED
BBCBE->CFAFFDAFBF
EBEDC->ADCDADEFBD
CEFEA->FDDCABDCED
DCDFF->CEBAAEABAD
CBCDE->DFAFEBCBBA
ECEBD->FCDEBFCDAE
EFDEC->ADABCEDCEB
AEEBF->BEDCBACDBE
DBFEB->CEAFABDCAE
FADAE->BCBCAEBCBA
FCEFA->CADEBFEDBE
EAAFE->FAFEBEABBF
FECAB->DCDCEFBCFE
FADDC->BEBCFCCBEB
DBFEC->FCAFBEFAEB
ABABD->FBCDDCCDBA
CEACF->DEFACDBADC
AFCCE->BCEDBFDEAD
FFFEC->ADABACFAFD
CBDDC->EFCDBAEFDE
BBABF->ECAFCDCDBE
FFFFE->ABEDEAABBF
EECEE->FCFADAFAFB
FFADF->CAEDBCCBDC
DDAAB->EBEFBCFEED
ACABF->CFDEFBCDEA
BDCAB->FAEFDABCEC
FADDB->EABCFCCBDA
FEBDF->ABDCAECBCA
DFEFE->CAEDBAEDBF
ADCDD->BCCBEBCBCE
FCBDA->BEDEEDEFBE
BFECB->CFEDABBAEC
ABEDC->BDAFBACBFD
CDBEB->EFCBECDCEC
FABFB->CAFECFEDCF
EAEAF->BFBCBABCBE
CAEEF->DEBCDFDCCA
CCDCF->DADEFABADC
CEDDA->EBDCFCCBFD
DFAEE->FAEDFBFAFB
CABBF->DEBCAEAFCB
AECFC->FBFADAABDE
BCFAE->ACDEBEBCDF
AFAFC->BEABCDABFD
EDECA->CBEFBFDEDC
DAFDD->EFBCCBCBFC
BEDCD->EDFACEBAAE
DCEFE->FABABAEDBF
ADDCC->DCEFAFBAEB
CFAFE->FEABEDEDAB
AADBE->DCBCAECDAB
FFDFF->ADABEBABAC
DBBFF->AFCDEDABCB
EEADA->CBDCBECBCD
BCCFB->CEBAFDEDCF
BDCAC->DECBFDFEDA
CADBC->DABCFACDAF
CBEBC->DACDFACDBF
DEDFA->AFDCAEABDB
BADBC->AEFEFCAFFE
ECECC->ADDEDBDEFD
DCACB->AEDEDCDEDA
CCACE->FEBADBDEBF
ECAEA->BABADBDCBE
DEBEC->FADCFEFADA
BACDB->FABCFECBEC
FCCDF->ACBAEBCBDC
ACABE->FBDEBEAFAB
FCFAF->ACBADCFEBC
DEBAD->BCFAEDBCAE
AFFDF->CFABCBCBCB
DADAD->BCFEFCFECA
CCDBD->FDBAEFCDCA
AECAA->BEDCEFBCDC
EFEBC->BAEDBFCDFD
CDFFD->FECBCBEDAE
EBFFB->BACDBEABAE
ECFDE->FCDEBCEFCB
FCDBE->ADBAAECDAB
FADDC->BEBCFCCBEB
EFFBF->DBEDABAFAB
DFAEB->EBABCDFAEC
CCCBE->FDBAFECDBF
FECCB->CADCEFBAEC
ECEAA->FBDEBABCFB
EBDBD->FCAFEAAFCE
DEBBE->AFDCFECDAB
BEAAC->AEDCBEFEDF
ABFFA->BCAFBEABFD
DEEAC->FCDCDFFEDF
CDEAA->BDCBBABCFB
BDDDA->ECEFEBEFBC
ACECD->DBDEBFDEAE
FFAEF->ACABDCFADC
BDDCC->EDEFCEBADA
AAFAD->CFBCCBFEBA
ABCCC->FBCDBFDEFD
EAFBC->BABCBECDBF
ACEBD->BEBAFBCDBA
AEEAD->DBDCBABCEB
ADFBA->CDCBDCAFCD
BBBAD->ECAFEDBCAE
ABBED->BCAFACFAAE
BEDBE->DADCFCAFDB
EFCFA->FCABDEABFD
AFBFF->CFABFEABAD
AFDCE->DCABFCBABA
FEDFA->CBDCAEABDB
ECBAA->CBDECDBCED
FFCDC->BEABEBCBEB
CBCEA->FDAFDEFACD
FFFCA->ECEDABDEFB
FFFEB->CAEDCBDCFE
ABABA->BEAFBCAFCF
DEAFB->EBFACDABFE
EFCCF->BAEDAFDEBC
ABDFD->DCCDBAEDFA
DBCED->BCAFDAFAAE
EDCBB->FACBEBCDED
DEECB->EFDCDFBACD
EBCBB->DFAFFDAFED
FDFAE->CBCBCBFEBF
ADCAA->BCCBEBFEFB
EBCDD->ABAFFECBFC
FBBDA->CACDCFCBCD
AEBEC->FBFACDFABD
EBEED->ADCDADFAAF
BDEDF->ECEFBFEFCA
FDBFD->BECBDAEDFC
BDEAE->CDEFABFEBF
BFECE->ACABBFDEBF
BFDFB->FAEDAFABED
EFEFC->ADABBAEDAF
FAEDD->ADFEFACBCE
CFECF->EBEDADDEBE
DECFF->EBFADAABAC
ECCDF->ADDEAFEFCA
EDEDF->BFEFBFEFCA
DABEC->EFBCAEDCEF
EBBBB->BACDEDCDED
CFCDC->DFEDAFEFDE
EAFBE->FBBCBECDAD
EACDD->ADBCBFEFAE
DAEBE->FAFEADCDAD
CAFFE->DABCABEDAD
ABABC->DCCDFBCDBF
BAFAE->ECFEBCBCAD
AEABF->DCFAEDAFBC
DFDDE->BAEDFACBDF
BFAFB->ECEDBCEDFE
DCDAD->EBDEFAFECA
CDBBE->BDCBDACDAD
AFFED->BCEDEAFAAE
DBDBB->FCAFBACDCF
BBCDE->DACDBFEFAD
FBFAB->DCAFBCBCFE
EFCBB->BFEDEBCDED
ACCCC->DCDEBDBADA
FDFFD->CBCBCBEDAE
FBAEB->ACAFBEDCEC
FFDEB->EAABEBFACD
FBDEC->CBAFCEDCEB
ECCCC->BABAEBDEAF
BACDF->CFFEDFCBEA
BBDBE->CDCDCACDBA
CCEDF->DADEABCBCB
AFFDB->FDEDABCBDA
AEDFA->EFFAEBABCD
EAACC->BABCFBDEDF
ADBCB->DBEFEDBAEC
BDCEB->CECBDAFACD
BFFEB->ECEDCBDCFE
ADFEB->EDCBACFACF
DCDEB->EBDEFADCFE
AEEBE->DBDCBACDBF
CDCBC->ABEFDACDEF
DDACD->EBEFBCBAAE
DCEDC->FABABACBFD
EFFDE->ABEDBECBBA
FFABF->ABEDDCCDBE
EDAAC->FACBFDFEFD
BCDFA->DADECAEDBE
AFABC->BDABDCCDAF
FEAEF->CADCBEDCAB
EAAEE->CDFEBCDCDF
FEEDF->ACFADFCBAC
DCAEF->BADEDCFADC
DCEDF->EBDEABCBCB
AFEAE->DBEDABFEBF
CAFFF->DEBCCBEDBE
ECFDF->CBDEBCEFDC
EFFAC->ADABDCFEDA
FABDB->DCFECDEFCF
CDDBD->EBCBCEAFEA
CAACB->DEBCEDBADE
DBEDA->AFCDBFEFCD
EEFFF->ABDCEAABAC
BADDC->DABCAEEFDE
EDFDD->ADEFDCEFEB
BCDDA->CFBAAEEFCD
CDBCF->BDCBDADEBE
FFBBF->DEEDECAFBC
EEEAD->BFDCBABCEB
EFFFE->FAEDEAABBF
ACACA->BDBABEBABC
DBEED->EAAFBADCAE
CAEEE->DABCBADCAD
ECFEF->DBDECBDCEA
FFEBD->EAABBFCDAE
AAACE->CFBCEDBAFC
AAACB->EDFEDCDEDA
BEBDD->ECDCECEFEB
DFADA->EBABCDCBFD
ACCFA->CDBAEBEDDC
CCBEF->FEBAECDCAB
FDEDF->CAEFBFEFCA
BFECE->ACABBFDEBF
ACECF->BCBAFBDEAD
DDDDE->FACBFCCBBA
CEAFB->DAFACDABFE
FCFBF->BCDEBECDEA
CDACD->BFEFDCDEAF
DDFCE->CAEFBEDEDB
BDDAB->DECBFCFEED
DBCBD->AECDFDAFEB
CFFEE->FEABCBDCAD
BBEFF->ECAFBFEDAB
BEEAB->DEDCDFFEEC
CEDEF->FEFAFCDCCB
BDBCC->AECBEDBAEB
BACFF->DABCAFABAC
BEEFE->CDFACBEDAB
FABFB->CAFECFEDCF
CBABC->ABAFBEAFFD
BCEBF->EDBABACDBE
AFFDB->FDEDABCBDA
FBECD->ADAFABBACE
BACBF->EDBCAFCDCB
DAEAC->AFBCADBCBF
CEECD->EFDCADDECA
FDDAA->CBCBFCFEFB
AECDC->DBDCEFCBFD
AADCE->BCFECADEAD
CADEF->DABCFADCEA
FACBC->CAFEFDAFDE
AFCFA->BEABDEABFD
ACFDC->BDBACBCBFD
BEEFE->CDFACBEDAB
FEEFB->ACFADFEDFE
ADDEA->BDCBFCDCED
DECCD->EFDCEBDECA
EAAFE->FAFEBEABBF
CCDCC->EFBACEBADA
EDBAF->BFEFEDBCEA
ADBEB->CDCBDADCAE
BDBAA->CFCBCDBCED
DFBAD->EFABDEBCAE
BFFEE->EDABCBDCAD
CAADF->EBFEFBEFBC
AEADA->BCDCEDCBCD
FAFDC->ADFEABCBEB
FEFAC->CADCABFEAF
BBCDE->DACDBFEFAD
CECDF->FEFAFDCBCA
CECFB->FEFAFDEDCF
EBFED->BFCDCBDCAE
CFDAA->DAABEBFEBE
EDBCB->BFEFEDBAEC
FFFCA->ECEDABDEFB
BAEBF->DABCADCDEA
DBFBF->EAAFADAFAB
FDFCE->ADEFCADEBF
BCCFF->EDBAEBEDEA
BCCCD->ACDEAFDEAE
ACFAB->FDBABEBCAE
DBEAA->AECDABFECF
DDCEB->FCCBEBDCAE
DFFFC->AEABADABDE
BDDEB->ECEFEBFACD
EAADD->BABCFBEFEA
BDBFA->CDEFCFEDBC
AEDAB->DCFACEFEEC
EBECF->BACDBFDEBC
AFCBC->BEABDECDBF
DABDC->AFBCFEEFDE
BDFBC->ECEFCACDFD
DDFAC->EBEFBCBCAF
BCDFB->ECBAEBABDE
FAEBD->CBFEBFCDAE
EFDBB->FCABEBCDCF
EFCCC->BFEDEBDEAF
CCAAD->EFBADBFEAE
BDDAB->DECBFCFEED
ADEAE->BCCBBABCBF
CAECF->BDFEFADEBE
FAAFD->ADFEBEABEB
FEEAF->ABDCDFFEAB
AFBAF->CDABFEBCAB
BADCB->CEBCEBDEEC
CABBF->DEBCAEAFCB
BDFBA->DECBCBAFBE
BEDDB->ECDCFACBEC
EDEDC->BACBDFCBDE
CBEDA->FECDBFEFCD
EAECF->ABFEBFDEBC
FBFCE->CBAFADBAFB
BAEEB->DEBCADFADA
CFCEB->FEABFDDCEC
FEACC->BEFAEDBAFE
FCEDA->DCBAFBEFBE
BAEFF->CFFEFAEDEA
CBCEA->FDAFDEFACD
DCAEB->CEBABCDCAE
ECCCB->FADEAFDECD
ECFDF->CBDEBCEFDC
BEBDE->CFDCDECBDF
EAEDB->ADBCDFCBCD
BEEDA->ECDCBACBED
BBECE->CDCDADDEDB
CBDBC->FDAFEBCDFD
DCCCE->FCBAEBDEDB
FEBCB->ACFACFBACD
AECDF->DCFAEBCBDC
EFCEA->CBEDFDDCBE
FBDFF->ACAFCEABAC
CCCFE->AFDEDAABBF
CEDBC->ABFAEBCDFD
DFEAF->EBABBFBCAB
BDDDC->FEEFEBEFFD
CDABB->FDCBCFCDFE
AEBCA->CDFAECBADC
ADCAB->DCEFBDFEEC
ADEEA->DBEFBFDCBE
ADAAC->EDCBCDBCAF
DBABE->FCAFCFCDAD
ECEEF->BFDEBFDCAB
BABEB->CFFEECDCEC
BBCCA->CDCDBFDEBC
EEBFF->BFDCECEDCB
BFABE->CFEDBCAFDB
CCAAE->DFBABEFEFA
AEFFB->DBDCABEDFE
BEEAF->CDFACBFEBC
DFEEB->FCEDADFADA
AACDE->DBFEDAEFAB
DAAEB->AEBCBEDCEC
BAFFC->DABCEAABDE
ABCDA->BEAFFDCBCF
CAADB->DABCBECBCD
ABEFD->FBCDADABCE
EBAEE->FACDDCFABA
CFAEB->DAABCDFAEC
DEFEA->AEFABEFAED
ECEEA->FCDEBFDCBE
ABBBF->BEAFCFAFAB
EFFBB->BAEDBECDFE
ABAFB->CDCDFBABDE
EFBBD->FCABDECDBA
FCCDC->ABDEAFEFDE
ABFCA->BDAFADBABC
ACCAF->BCBADABCAB
AECEB->CDFAEBDCAE
DFEAD->EAEDFCFEFA
BBFED->ECAFBCFACE
CCDBB->EFBACEAFCF
EDABF->ABCBEDAFBC
DDCCC->EFCBEBDEAF
FDFAB->CAEFCAFECF
BAFBA->CFFEABAFBC
BFFAE->CFEDCBFEBF
CEFFC->DAFABCABFD
BBBFE->CDCDFEABFA
CCDCE->FDBAEFDEDB
DBEED->EAAFBADCAE
DFABB->CEABCDCDED
AEEFC->DBDCBAEDAF
DAAEF->CEFEBEDCAB
EABAF->BABCEDBCEA
DAEEB->CEFEFADCAE
ACBDE->DCDEDACBBA
CABFA->EBFEEDABED
FEDBA->ECFAEBCDBC
EDECE->BFEFBFDEBF
AADDD->DBFEAEEFEB
EFCCE->FAEDBFDEAD
CDFBD->BFEFBECDCA
CABFE->FEBCFEABFA
CBCCB->FECDAFDECD
CFFCB->DEABDCBACD
CBEEF->DACDFADCCB
EEFEB->FCFABCFAEC
DFDDC->AEABAFCBFD
BDAFE->DACBFDEDBA
FBBDA->CACDCFCBCD
BCFDF->CDDEBECBDC
EEDCA->BFDCFABADB
CFFDA->FDEDCBCBED
FECAF->CADCEFBCEA
FCBDD->ABDEEDEFCE
BFBEC->EDABFEFADA
CDBBF->EBCBDACDEA
FFDED->CAEDFADCAE
CFACC->EFEDDCDEBD
BDDDC->FEEFEBEFFD
DEFCB->AFDCEADEEC
BCDEF->DADECAFABE
EFFCF->BFEDABDEBE
EAFFC->ADBCCBEDAF
FABEF->ACBCEDFADC
CBEEF->DACDFADCCB
CEACC->DFDCFBDEDF
FEEFA->BCFABAEDFB
DFDDC->AEABAFCBFD
EBFCC->FCAFABDEAF
FBEED->BECDADFAAF
FADDE->ADFEFACBDF
CDABE->FECBEDAFBF
DBEEF->EBCDABDCEA
CDEED->FECBDFDCEF
ABDAC->BEAFEAFEFE
BFBDC->DEABFEEFDE
EFEAB->BAEDBFBCEC
DDFFE->FACBCBEDBF
CBACB->DACDDBDECD
ACACE->DCDEDBDEBF
CEEEC->DAFAFBFAFD
FDDBD->BECBCEAFEA
EACBE->FAFEDFAFBA
DBAFB->CEAFBCEDFE
AEDFA->EFFAEBABCD
CCCDA->FDBAFECBED
AAFBA->BEFEABAFBC
BEFEE->ACFABCFABA
DDDAA->AFCBFCFEFB
DAEEC->FCFEADFABD
ADBDE->BCCBDACBBA
AAAAA->EFBCDBFEDC
CECBF->EBDCEBCDBE
BDBAA->CFCBCDBCED
EACBD->FCFEDFAFCE
AFCAE->FBABDEBCDF
CAFFE->DABCABEDAD
FBFAB->DCAFBCBCFE
AEEFB->CFDCDFEDFE
EEEDE->ABDCADEFCB
AEAEB->EDDCBEDCEC
DCFFB->EFDEBEABAE
FBCCA->DCAFDEDEFB
EFFFD->FCABACABAE
EEBDB->DFDCDECBEC
BEAFB->CFDCBDABED
DAAEE->AFBCDCFABA
AAEDD->BEFEFACBCE
FEACB->EAFACDBAEC
FBCBE->ADAFFDAFBF
EDACB->ADEFDBDECD
FDEFE->CBCBDFEDAD
CFFAE->DAABACBCBF
ACFFC->DCDEADABDE
FFAFE->CBEDFBABBF
DBCCA->EFCDBFDEBC
BEEFC->ECDCBAEDAF
FAEAA->ECFEBABCFB
DABAE->BAFEECFEAB
FCEAE->CBBABABCBF
DABCD->EAFEACDECA
AACDD->CFBCBFEFAE
CFCEB->FEABFDDCEC
DCDFD->EFDECAEDAF
EFDCB->BFEDAFBAEC
BCBBD->ACDEEDCDBA
ADCFA->EFEFDAABCD
FDFBD->ADEFCACDAE
BFAAF->EDABEDFEBC
BAFAC->DEBCEABCBF
ABEBA->BDAFBACDFB
ACDCB->DCDEAFBAEC
CCFCB->EBDEBEDEED
FEEAC->BEFABABCFE
CDFED->EFCBCBDCAE
BBEBF->ACAFABAFBE
CACEF->FDFEDAFABC
CCBFD->FDBADEABFC
ECCBE->BFDEDACDFA
FDBAB->DCEFEDBCFE
FCFDF->ABDEBECBDC
AEEBE->DBDCBACDBF
FEACA->CBDCDCDEDB
ADFFE->FBEFBCABDF
FFFFC->CAEDCBEDAF
BCBDD->FEDECDEFEA
FDFDF->ADEFCAEFCA
CCAFB->FEBADBEDCF
DFCDC->FCEDBFEFDA
FDDEE->CBCBFCDCDF
EFABE->FCABCDCDBF
CCFAA->FDBACAFEBC
EFCAC->FAEDBFBCEB
CAFFC->DFBCBEABEB
BDCAF->CFCBDEBCCB
ECCBA->CBDEDACDDB
FDFDA->DCEFCAEFCD
EADCE->FAFEFABABA
DABAC->AEBCECFEDA
EFFDB->FCABACEFEC
EBAED->FCAFBCDCFC
BACBD->CFFEDFAFCE
CBFAD->EFCDBEBCFC
BFFBC->DEABCBAFEB
DBFAE->FCAFBEBCDF
BAFCF->DABCEADEAB
FBCCC->EACDEFBAEB
AEFCC->FBFABCDEAF
EBCFD->FACDBFABAF
EFBEF->BFEDECDCAB
ACACE->DCDEDBDEBF
DBCBD->AECDFDAFEB
DFDEE->CAEDAFDCAD
EECED->BFDCEFDCAE
FFFCD->EAABACBACE
BFBFE->ACABDEABDF
ACFDB->CDBADCEFED
EFEAE->BFEDBABCBF
BDCCC->FEEFDEDEAF
FACBC->CAFEFDAFDE
CCBED->BFDECFDCEF
FDFDC->EAEFBCEFBD
DFBBA->CEABDECDFB
BEDDF->ACFAAEEFCA
CDDEB->FDCBEFDCAE
CDDCB->DECBCEBACD
CBAEB->EBCDFBFACD
FCCEC->ADBADAFADA
EFABB->DFEDDCCDED
ABBAF->BCAFACFEAB
FFEDD->ABEDADEFAF
FDBEC->BECBDADCEB
ABCEC->EDAFDEFADA
DBDED->FACDBADCFA
CEFBE->DAFABCCDBF
AAACD->FBFEBEBAAE
BBFDD->CFAFABCBCE
DFEFF->BAEDABEDBE
BAFCC->FEBCABDEAF
ABBBB->DCCDEDCDED
ADFEE->CFCBDCDCBA
EADAD->BABCEBFEFA
AEACC->BDFADCDEBD
ECDCA->CBDEAEDEDC
FDFFC->ABCBDCEDFD
BCDEF->DADECAFABE
DDAEE->AEEFCDFABA
CCEFA->FDBAFCABCD
ABAFA->EFCDBEABCD
DCFDA->AFBADCEFCD
DAAEA->FCFEFBFACD
CBFCA->EBCDBEDEFB
DACDB->AFBCAFEFED
ADFCC->BDCBCBBAEB
BFEEB->CEABADFADA
ADFFB->FDEFCAEDCF
ECCEE->CDBADEFAFB
AADEC->FBFEFADCFD
FBBAF->ABAFCFFEAB
EACBF->BABCFECDBE
AFADF->DBEDBCCBDC
DCAED->AEDEDCFACE
EDABB->BFEFCDCDED
DFCED->EAEDFEFAFC
BEBCF->EDFAECBABE
DCFEB->AFBADCDCEC
DFBAF->CEABDEBCEA
CEBED->EBDCAEDCFA
ADABC->BECBCDCDAF
BADAC->FEBCFAFEAF
CDFDD->EBCBDCEFEB
AEFFC->BEDCABEDBF
ACAEE->BEBABCDCDF
CFDBD->FEABFCAFBA
CBDCB->EFCDBADECD
CCBBB->DEDEEDCDED
FDADD->CAEFCDCBCE
EDFEC->BACBCBDCFD
DAAAB->CEFEBEFEEC
ABCDB->EDAFDECBDA
AAAEE->DCBCDCFABA
FDDDD->CBCBFCCBCE
DDBCB->AEEFEDBAEC
EBDCA->BACDBADEDC
DECEC->FCDCEBDCEB
FBEAF->ACAFBABCBE
FFEBC->CBEDBFCDFD
EECBE->ABDCFDAFBF
DCAFA->EFDEFBABCD
DDECB->AFCBDFBACD
EABAB->ADBCAEFECF
CABFF->BDFEECEDCB
CAEFB->FEBCADABAE
ECCCA->FCDEDADEBE
FBEBF->BCCDBFCDCB
FEFCC->EAFABCDEAF
DFCFD->FAEDAFABEB
BAFFF->CDBCCBEDBE
DFAEE->FAEDFBFAFB
CACCB->EFBCAFDECD
ACCAD->DBDEDABCFA
CEEAE->DAFAFBBCBF
FDEEE->BCEFCBDCBA
ACEEE->CFDEDBFABF
EFECA->BFEDBABADB
BABEA->ECFECDFAFD
BDBDE->CDEFCFCBBF
CDBEC->DFCBCFDCDE
FBCEB->ADAFFDDCEC
ACAFE->DBDEDCABDF
BFADB->CDABFDEFED
DDAEE->AEEFCDFABA
BAABD->CEBCFBCDCA
AECAF->DBDCEFBCEA
ABBAB->CDCDEDBCFE
BAEAB->CDBCDFFEEC
EBDFD->BACDBAEDFA
BCCEE->EDBAEBDCDF
CAEEA->FEBCADFAFD
BEEEA->DADCDFDCBD
ADBDD->BECBCDEFEA
EDBCD->FACBDADECA
EFFFE->FAEDEAABBF
ECFBB->BFDEBCCDED
BEBBF->ACFACDCDEA
ABBAA->EFCDECFEDC
BCCBE->ECBADECDAD
FDAEC->EAEFBCDCEB
BEACD->ECDCBEBAAE
DCAED->AEDEDCFACE
AFEFA->EFABADABFD
DDFAA->FCCBDCFEDC
CCFCB->EBDEBEDEED
DACAA->FCFEAFBCBE
CEAEC->ABFACFDCEB
AFFAB->CDABCBFEAC
EAAAF->CBFEDCBCEA
EDFAD->FACBDCFEAE
CFAFB->FDEDBCEDFE
AFDCB->DBEDFABAEC
DDFDB->AFCBCBCBEC
FBBFA->BCCDEDABED
CBBFD->BFCDECEDFA
EACAB->BFBCFDFECD
CFECB->DAABBFDECD
CCEFC->DEDEDBEDEB
CACBF->FEBCAFCDCB
DCFCB->FCBADCBACD
BDCBF->ECEFDECDEA
FEBBB->CADCECAFED
FABBE->ADFEECAFBF
EFCEB->BAEDAFDCEC
DBCAD->EBCDFDFEAE
CBFDC->FDAFBCEFBD
ECFAF->ADDEBEBCCB
AFBCA->EFABEDBADB
BCCBA->CDDEAFCDBC
BEECB->CDFACBDECD
AAFAD->CFBCCBFEBA
ACAEE->BEBABCDCDF
AEBAF->CFDCAEFECB
AEFDB->EDDCABCBDA
FFEEB->ACABADFADA
BDBBA->ECEFEDCDFB
ACEBF->DCDEBACDBE
EEDCD->BADCAEDEAE
EEAFC->FADCEDEDFD
EEECB->FADCDFBACD
FECFD->BEFAEBEDFC
EFDED->BFEDAFDCAE
EECFA->CBDCEFEDDC
CCECC->DFBADFBADA
BFDAE->DAEDFCFEAD
FFBBD->ADABDECDBA
EBDFC->FACDCAEDEB
DFFEC->EBABACFAFD
CEFBC->DFDCBECDBF
BEDAC->DEDCFCFEAF
FBBDB->ADAFCFCBCD
FFFFA->BCABCBEDFB
BFEAF->CFEDABFECA
AADBD->BCFECACDFC
CAEBD->FEBCADCDCA
CADDE->DABCFACBDF
FBEDF->ABAFABCBCB
ACDBD->DBDEAECDAE
DDAFE->FCCBFDEDBA
ADFCB->CDCBDCBACD
BEFBC->DADCCBAFEB
DEAEE->FCDCEDDCBA
BFBBD->CFEDCFAFEA
AFBBA->CDABFECDBC
FEADB->CBDCDCEFDA
BEBBA->DADCAEAFDC
FDDBD->BECBCEAFEA
DBFCA->FCAFBEDEFB
FDDFB->ACEFCEABDE
BEEBB->FAFABFCDCF
CCFBA->EBDEBECDDC
BFBBA->DEABFECDBC
DEAEA->EBFACDFAED
EFABE->FCABCDCDBF
AFDAB->EDEDFAFEED
CFEED->BFABFADCFC
FCFBD->ABDEBECDCA
BEADC->DEDCEDCBDE
ACEBB->CFDEDBCDCF
ABBDD->DCCDEDEFCE
FFBAD->ABEDFEBCFA
EBCFD->FACDBFABAF
DAABC->FAFEFBCDBF
AEEFD->BEDCBAEDAE
DABBA->AFBCFECDBC
BDCCD->EDEFEBDECA
AECDE->BCDCEBCBBA
FEDFF->ABDCFCEDEA
FEDBA->ECFAEBCDBC
CEDAD->EBDCFCFECA
BECBE->ACFADACDFA
FFEEF->DEEDBADCEA
CFDCF->BDABEBDEAB
CCCEA->EBDEAFDCBE
ACBEB->CFDEEDFAEC
EDAFD->ABCBEDEDFA
CDEBE->DAEFABAFDB
CABEF->EBFEEDFADC
ECCBF->DBDEFDAFBC
CBFAA->DACDADFEBE
EBDCA->BACDBADEDC
EACAC->FCFEDFBCFE
CFDCE->FEABFCBABA
BDEBD->ECEFBFCDAE
EBCCE->BFCDFDBAFC
AFFFE->BCEDEAABBF
DCADC->AEDEDCEFBD
DAEFB->AFBCADABAE
BBDFC->FECDAEABEF
FACFE->BCBCAFABBF
BCDCC->DEBACEBADA
BBEAB->CFAFABFEAC
BEBAB->CFDCDEBCFE
BACEC->EDBCAFDCEF
CBDEF->FDAFEBFABC
FABCE->CAFECFBAFB
EBACF->ADCDDCDEAD
DDBBA->AEEFEDCDFB
ACDAA->CDBACEFEBE
ADEFA->BDCBDFEDDC
CADBF->BDFEFACDBE
DBBFB->FCAFACABDE
CCCEE->FEBAEBDCDF
DBAFD->AECDBCEDFC
EBACE->ABAFCFDEDB
CEFCD->EBDCCBBACE
DACBA->CEFEDFAFBE
ACECF->BCBAFBDEAD
ECFFA->FCDEBCABED
BEDEB->CEDCAEFAED
FDEEF->ACEFBADCEA
FDDAE->ADEFEBFEFA
CDEFA->EBCBBAEDFB
EFAFD->FAEDDCABFC
FCBBC->CBBAECAFDE
AFCEF->BEABDEFABC
BACCF->CDBCBFDECB
CFADB->DEABFDEFED
FABFA->BEBCAEEDBE
FCBAE->CADECDBCDF
ABACD->DCCDFBDEFA
DFFCF->AEABADBABC
ABBEB->DBAFCDFADA
FFBFE->BCABFEABFA
AEDBE->CFDCFCAFDB
BDDFF->EDEFCEABAC
FAABC->EABCEDAFDE
FEAFC->ABDCEDEDFD
BDEAE->CDEFABFEBF
DBDEA->EBCDAEFACF
DFEAB->AFABADBCAE
FCAEA->CBBADBDCBE
EDEAF->BACBDFFEAB
DABAD->EBFEECFEAE
AFBDB->DCABFEEFED
ECCAD->BFDEDABCFA
EACFC->FAFEDFEDAF
AEBBA->BDFACFAFBC
EAAAC->ADBCEDFEDA
CBBCE->DFAFECBABF
FCFFD->EADEABEDFC
FEFCB->CBDCEADEEC
CBAAE->FDAFCDBCAD
CCDBB->EFBACEAFCF
DAEDD->EBFEFACBCE
ACDEF->CFDECAFABE
BECCB->ECDCEFBAEC
DFBFD->BCEDECEDFA
CCFDB->EFBADCEFED
EEADD->ADFAFDEFEB
EFAAE->FAEDDCBCAD
ECCED->FADEAFDCFA
EBFEA->BACDBEFAED
DEDBB->EFDCFCAFAC
CFFDB->DAABACEFEC
DEDCE->FADCAEDEBF
BEBEC->DEDCAEDCEF
CFADF->FDEDBCCBDC
FCBEB->ACBAECDCEC
EFDDD->FCABEBEFEA
EAAEA->FBBCFBFACD
EDAFD->ABCBEDEDFA
CBDCB->EFCDBADECD
EFBAC->FCABDEBCAF
AFBFA->DBEDCFEDBC
EFCBB->BFEDEBCDED
FABEC->ABFEEDFAEB
ACBAE->DBDECDBCDF
EECAE->FBFAFDFEAB
EEBBE->CDFAEDCDBF
BDEAE->CDEFABFEBF
BEFDD->ACFABCEFAF
FEFEB->ADFABCFAEC
CFEEF->FEABDFDCCA
FCDDD->EADEFACBFC
BCABB->CFBABCAFAC
DEAFD->BCFACFABFC
EFDAF->BFEDAFBCEA
FEFDD->EAFABCEFAF
BDFCE->CFCBACBABA
AFBFB->FDEDECEDCF
AADDF->BCFECAEFBE
EADCC->BFBCFABAEB
EFBFF->ADABAEEDAB
AEDDA->BDFAFCCBFD
BBDFF->DACDCAEDAB
CCABB->DADEBEAFCF
DCBDF->CEBACDEFBC
BBABE->DACDDCCDBF
CCAAB->DEDEFBFEEC
BCDDA->CFBAAEEFCD
BAAFB->CEBCFBABDE
BDAEC->DECBEDDCEF
BDDFE->CDEFEAEDFC
AEBCD->BEDCECBAEB
ADBDF->DCEFDACBDC
BAECA->DABCADDEFB
EFCEC->DFEDBFFADE
BBBCC->EDCDEDBAEB
CDBDB->EBCBDACBDA
CECCE->FEFAFDBAFC
BFBAD->FEABECFEAE
CAFFF->DEBCCBEDBE
CFCEF->DAABDEFABC
FBAFF->ABAFBCEDEA
DADFD->FAFECAEDAF
CFADD->EFEDDCEFAF
FDFAF->BCEFDCFEBC
ACBDA->BDBACFCBCD
EEEAF->CBDCBABCBE
DBBCF->AECDCFBABC
DFCDB->CEABDECBDA
BCDBC->DADECACDEB
CDFDA->DECBDCEFCD
FDDDF->ACEFCECBAC
DCEFA->AEDEBFEDBE
DEFDC->AFDCEAEFFD
AEBAB->FDFAEDBCFE
FDCDE->CBCBFDCBFC
FAAEE->CBFECFDCDF
BEACC->DADCEDBAFE
DCAFE->AEDEDCABDF
CCAAE->DFBABEFEFA
ECBDF->ABBAECEFCA
FDBCB->CAEFEDBAEC
FBBEB->CACDCFDCDE
EEDCD->BADCAEDEAE
EBFFF->DBCDCBEDBE
BFDEF->CDABCEDCCB
BDCBE->DACBEBCDBF
ADACE->BCCBFDBABF
CCFEC->EFBADCDCEF
FECAD->EAFADABCFA
FDEFF->BCEFCBEDCB
CEAAB->FDDCBEFEEC
BAFBA->CFFEABAFBC
FFFEF->BCABCBDCEA
EFDED->BFEDAFDCAE
AECBC->EDDCEFCDAF
DBBCB->EFCDFEDECD
EEAEE->FBFADCFABA
FFEDB->CAEDABCBEC
ABACA->DBAFDCDEDB
CCBFD->FDBADEABFC
BAEBD->EDBCADCDCA
DEABB->FCDCEDAFED
FAFBE->BEBCCBAFBA
DBADE->AFCDFBEFAB
FEAFA->CADCBEABCD
BBDBD->CFAFEAAFCE
DCABE->FABADBAFAD
EADFE->FBBCEBABBF
AAFEE->BCFEBEFABA
CBECA->BDAFABBADB
CCFBA->EBDEBECDDC
BFCCA->DEABFDBACD
EFCCB->ADABEBDEED
ECFCE->FADEBEDEDB
CECAE->DFDCDABCBA
CACDC->EFBCAFEFDE
EDCCB->FCEFFDBADE
CCFBE->FEBADCAFBF
FBDAF->BCCDBAFEAB
FBFAF->CACDCBFECA
EFAFF->ABEDFBABAC
AABEC->EDFECDFABD
AFEAA->BCEDADBCED
DAACD->FAFEFBDEFA
ACFCA->CDBADCBABC
BAECC->AEFEBABAEB
FDECE->CAEFBFDEBF
CECEB->EFDCFDDCEC
FFAFD->ABEDDCABFC
FDBAB->DCEFEDBCFE
FDECF->ADEFBFDEBC
DDDFD->EBEFEAEDEB
BAEBB->CFFEFACDFE
CAEED->FDFEABDCAE
DBFDA->CEAFABCBFD
FBCFF->BCCDAFABAC
BAECF->ACFEFADEBE
AECDC->DBDCEFCBFD
BBECD->CFAFABBACE
ADBDA->CDCBDACBFD
CEEFB->EBDCDFEDFE
EBEEA->CBAFABDCDC
EACED->ABFEFEFAFC
BDFAF->ACEFBCBCEA
FBFFA->DCAFBCABED
BCAAC->EDBADBFEDA
FAEBE->BCBCADCDAD
FCDCB->CBBACEBACD
AEACA->EFFACFDEFB
BEBFC->EDFAECEDFD
FBABA->ECAFDCCDFB
BEFBC->DADCCBAFEB
CABCD->EBFEEDBACE
CADCB->EBFECADECF
EFABE->FCABCDCDBF
ABBAE->BEAFCFFEFA
CEBCE->AFDCECBABF
BEBEB->FAFAEDFAEC
DFDBB->EBABEBCDCF
EEAFD->BADCDCABFC
FBFBC->ABAFABAFFD
EEAEE->FBFADCFABA
FCEFE->BCDEDBEDBA
FADEF->ADFEFADCEA
EEAFE->ABDCDCABDF
EEFFD->FADCCBEDAE
EEAAE->CDFACFBCDF
FEEBF->ADFAFBCDBE
EAFBD->ABFECACDAE
EBCAA->DFAFFDFEDC
DCBFA->AFBAECEDBC
CEDEC->FDDCFADCFD
ABAFE->BEAFBCEDAD
CCAFD->EBDEFBABEB
DEBDE->CAFAEDEFBA
FCBFB->EADEECEDCF
ECFBC->FCDEBCCDAF
EEADB->BADCDCEFDA
CFFBD->EBEDEACDFA
ADFBD->BECBACAFCE
CEABA->BDFACDCDFB
FDBCB->CAEFEDBAEC
CFEBB->DEABBACDED
DCACD->EFDEFBDEFA
ADAAD->DCEFDBFEAE
DEFAF->AFDCEABCCB
EAFDC->FCFEABCBEB
EABED->BABCEDFACE
CDDFA->BDCBCEABCD
AFCCD->BEABDEDECA
DABEC->EFBCAEDCEF
FAEAC->CBFEBFBCFD
ADCDE->DCEFBDCBBA
CABEA->FDFECDFAFD
CBBDF->EBCDEDEFCB
BFDCD->FEABAFBACE
ACCDB->FDBADECBDA
DAFFA->AFBCEAABCD
AACCE->BEFEDFBADF
CFFBA->DEABDCAFCD
AAAEE->DCBCDCFABA
FEDAB->CBDCAEBCEC
EAABC->DFFEBEAFFD
DFCBE->AFABDACDFA
FADCE->ABFECADEAD
FDDDF->ACEFCECBAC
FBCBE->ADAFFDAFBF
EACEA->FCFEDFDCFB
ACDBA->EFDEFCAFCF
EEFBD->BFDCABAFEA
FECDD->ADFADAEFEA
ADEAB->CFCBBABCED
CECBA->FDDCEFCDFB
EAADB->FCFEBECBCD
EEFDC->BADCEAEFFD
BFDCE->EDABFCBABA
EAAFD->FCFEBEABEB
FCAFB->CBBADBEDCF
FDABF->BCEFDBAFCB
DCEBD->EBDEABAFBA
CDEEB->DAEFABDCFE
ACEFD->DCDEBAEDAE
AEDAD->CFDCFCFECA
AADDD->DBFEAEEFEB
DBDAE->AFCDBAFEFA
EAFBF->BFBCABAFAB
CBEBA->EBCDBFCDBC
CFFDA->FDEDCBCBED
DDCEB->FCCBEBDCAE
EBBCA->FCAFCFBABC
DFDBF->EAEDEBCDCB
BFEBF->ECEDABAFBE
CCBDA->EBDEEDEFBE
ACCAB->CDBAEBFEED
CCAAC->ABDEBCFEAF
BDBDE->CDEFCFCBBF
EAEDE->FAFEFACBBA
CEFFC->DAFABCABFD
CCCCD->EFBAEBDECA
CCAAA->DADEBEFEBE
DBDCD->AECDAEDEAE
ECABD->BABADBAFAE
DFFED->EFABACFAFC
EDFDC->DFCBACEFEB
FDADC->BECBFDEFDE
CABEF->EBFEEDFADC
BBFEC->DACDEAFADA
FABDB->DCFECDEFCF
AACBF->DCBCAFCDCB
FEFCD->BEFADCBAAE
BABCB->FABCEDBAEC
FDADC->BECBFDEFDE
ECAEC->ADDEFBFADA
EABDC->BABCEDEFEB
ECECD->BFDEBFDEAE
ABDED->FBCDCAFAEB
FCADC->CADEDCEFBD
EFFFC->BFEDABEDBF
EAEDC->BFBCBACBFD
EABBE->FCFEECAFBF
DEAEC->AFDCDCFAEB
FDCFF->ABCBEBEDEA
AFDDB->CFABFCCBDA
FEDAE->CADCFAFEAD
ABFAA->BEAFABFEFB
CDCBD->EFCBFDAFEB
DDBBD->BCEFCDCDCA
ECDBE->FCDEAECDAB
ACDAA->CDBACEFEBE
BCFAD->EDBADCFEAE
BCCCB->CDDEAFDECD
EADFF->BFBCFAEDBE
CEBDE->DAFACDEFAB
EBCBC->ADCDBFCDEB
CDEBB->EFCBDFAFCF
DEBCD->EBFACDDECA
FCAAD->EADEBEFEFA
DEFCC->FADCEADEDF
CDBDF->FECBECEFCA
CDAFE->DFCBDCABDF
EBCFC->FCAFFDEDFD
BBABC->EDCDFBCDBF
BDDBA->CDEFEAAFBE
BFFCD->ACABACBACE
CFDDF->FEABFCCBDC
BCABA->ECBADCCDFB
DBBBD->EAAFECAFEB
DACBB->FCFEAFCDCF
FCBDA->BEDEEDEFBE
DFDDF->AFABAEEFCA
ECBAC->DFBACDBCBF
DEEEC->EBFAFBFAFD
AFECF->CFABDFBABC
CAAAC->DFBCFBFEDF
CDCDE->FECBFDCBFC
CBCDD->EFCDAFEFEB
EEFCE->BFDCABDEDB
BDBDE->CDEFCFCBBF
CDFDA->DECBDCEFCD
ADFCC->BDCBCBBAEB
FDABC->ADEFCDCDAF
BAEDD->CFFEFACBCE
DDAED->EACBDCFACE
FBEBF->BCCDBFCDCB
AAACF->DBFEDCDEAD
DAFEA->CEFEABDCED
AEFCD->CFDCCBBACE
FCACB->CADEDCDEDA
AFEFF->BCEDADABDC
BACCC->DABCAFDEDA
CECEC->DFDCDAFADA
EACAE->CDFEFDFEAB
EBACF->ADCDDCDEAD
BAEAE->DABCADBCDF
DFDED->AEABAFDCAE
EEFCA->CBDCABDEFB
FBBBC->EACDCEAFEB
EFEBE->FBABADCDAD
ABDCB->CDCDBADECD
BFACC->DEABEDBAFE
CDAFA->DAEFBCEDDC
BFCAA->ECEDFDFEDC
DADFB->EFBCFCEDFE
DFEFA->AFABADABFD
ABDEC->DCCDBADCEF
FBCAD->ADAFFDFEAE
DDABF->CECBCDCDBE
CDCDC->DAEFFDCBFE
CBEBC->DACDFACDBF
FDDFE->ABCBCEABBF
FFFCA->ECEDABDEFB
FAFBD->EABCCBAFCE
EEFBF->CBDCABAFAB
BBEEC->DECDBFDCEF
DADCC->AEBCFABAEB
AECDE->BCDCEBCBBA
BADDB->DEBCAEEFED
EFEBB->FAEDADCDFE
DDEFD->EFCBBAEDAE
EDDCF->BFEFEBDEAB
EFAAF->BAEDFBFEAB
AAACD->FBFEBEBAAE
BBAAB->FACDBEFEEC
EEEFE->FADCDFEDAD
CBCFA->EBCDAFABCD
ECFBF->ABBADCAFBC
FFBCA->CBEDEDBADB
BFDFA->CDABCEABCD
AFEDB->DBEDABCBEC
DCBAD->EABACFFEFA
DAAEC->EBFEBEDCEF
FDBEF->ABCBDADCCB
DBEFE->FCAFDBEDBA
FEBFB->DCDCECEDCF
ADDDA->DBEFEBEFBC
CCDCD->EBDECADEFC
FCEBD->ADBAFBCDBA
EFBDA->CBEDCFCBCD
AFBFD->DCABFEABAF
BBEEA->CDCDADFAFD
CDBDB->EBCBDACBDA
DCDDE->FCBACECBBF
FEDEF->DEDCEBFABC
FFFCD->EAABACBACE
BDAAD->EDEFBEFEFA
CCFBF->BDBABCCDBE
ECCCD->ABBAEBDECA
DAEEC->FCFEADFABD
DEDBF->AEFAEBCDCB
AACDC->FBFEDFCBDA
AEFAF->DCFADCFEBC
CAABF->DABCBEAFAB
CDAAB->DAEFBCFEED
DEEDD->BCFABFEFEB
FFEEC->CAEDABDCFD
BCFAD->EDBADCFEAE
DEACD->AEFACFDECA
AFBDF->BEABDECBCB
EDEEE->ABCBDFDCFC
BBDDE->ECAFEBEFAB
CBFEA->FECDBEFAED
CFAFA->EBEDDCABED
DCEBA->CEBAFBCDFB
EFEFF->CBEDABEDBE
AADEA->BCFECAFACF
DDDEE->AFCBFCDCDF
BACCE->CFFEDFBADF
BEBFF->ECDCECEDCB
FCEAD->ABDEDBFEFC
DCFBB->AEDEBCCDED
BEEAD->ECDCBABCEB
FCFAD->CBBADCFEAE
FDDCC->CBCBFCBAEB
BDFBC->ECEFCACDFD
CFFDF->EBEDEAEFBC
DCFAA->AEDEBCBCDC
AFEFF->BCEDADABDC
CACAA->EBFEAFBCBE
DCBBA->EBDEECAFCD
DBDEC->AFCDBADCEF
CFCDF->DEABEBCBDC
DFCCF->AFABDADEAB
CCEED->EFBABADCAE
CCDAC->FDBAEFBCBF
EFAEE->ABEDFBFAFB
CEABE->AFDCBEAFAB
ACFCE->BCBABCDEDB
EEEFB->ADFACBEDCF
DEEEA->FCDCDFDCBD
BEEBB->FAFABFCDCF
EEFCA->CBDCABDEFB
BCBCA->ECBAEDBADB
BDCFA->EDEFEBEDDC
FBDCD->CACDAEDEAE
EDFAE->CDCBEABCDF
CFDBC->DEABCEAFFD
FCEEB->DCBAFBFACF
EEBAC->FADCAEFEFD
CDACF->FECBEDBACA
DBBDE->FACDEDEFBA
EBFDA->DFAFABCBFD
ACDDF->DBDEAEEFCA
BEDAF->CFDCEFBCCB
DFDFC->FAEDAEABEF
BEBBB->ECDCECAFED
DCDCD->EABAFCBACE
FBCBE->ADAFFDAFBF
FDFFC->ABCBDCEDFD
AEFEC->EDDCABDCEB
BADDD->ECFEAEEFEB
CEBBE->FEFACFAFAB
AEAAD->BCDCEDFEAE
DCADB->FCBADBEFED
FBFFA->DCAFBCABED
FFEDB->CAEDABCBEC
EAAEE->CDFEBCDCDF
CEBFE->DFDCEDABDF
DAEBC->EFBCDFAFFD
FFDDF->DEEDAFCBCB
AADFA->BEFEFAEDFB
AAEEC->BDBCBFDCEF
DCDEF->EABAFCDCCB
BDCDD->FEEFDECBCE
ADAFA->BECBCDABED
BEBDB->DEDCAECBED
BDBAD->ACEFCFFEFA
BBFCB->ECAFBCDEED
CDDAF->DECBCEFEAB
FCACB->CADEDCDEDA
CBFEC->DFAFADFADA
DCEAC->EBDEABFEFE
ABBEF->CDCDEDFADC
CBDEE->DFAFCEDCDF
DBBFD->EBCDCFEDFA
DDFDF->EBEFBCEFDC
DDFBF->AFCBCBAFAD
AFACA->BCEDDCDEDB
DDBCA->FCCBDADEFB
DEFEF->EADCBEFADC
CBCFF->BDAFFDEDCB
FEBEB->CBDCFEFACD
DAADA->AEBCBECBCD
CDDFB->EBCBCEABDE
DBEBD->EFCDADCDCA
CBACF->EBCDFBDEAB
BCFED->CEBACBDCAE
DDCED->EBEFFDDCFA
AEAED->FBFACDFACE
CFECD->FEABDFBAAE
EDBEE->FCEFCFDCFC
EBDDC->DFAFEACBDA
FCFDB->EADEABCBDA
EBDBE->FACDCACDBA
FABCE->CAFECFBAFB
FBBAB->EACDCEBCED
FDFEE->BECBDCDCBA
ACCCC->DCDEBDBADA
EFEEE->FAEDADFACB
CEDBA->DAFAAECDBC
AFAEA->DBEDBCDCED
FBAAA->DCAFCDBCDC
BFCEE->ECEDFDDCBA
ACAEB->CDBADBDCEC
BEBEB->FAFAEDFAEC
DBDBC->AECDAECDFD
EDDBE->BFEFEBCDAB
EDBAC->BACBECFEDA
EFEBB->FAEDADCDFE
FFBDC->EAABDECBFD
BCDEE->ACDECAFABF
DFDED->AEABAFDCAE
AADDC->BDBCEBEFFD
DCBEF->AFBAECDCAB
DCEDA->EFDEDBEFDC
EEFED->BADCEAFAAE
BECBE->ACFADACDFA
DCCFF->AFBAEBEDEA
FBFCB->CACDCBBAEC
AEEAD->DBDCBABCEB
ECBAB->BABAECFECD
FEECA->ECFABFDEDC
DBFBC->EFCDEACDEF
BBFDD->CFAFABCBCE
AFADE->CFABEDCBBF
EEBDF->CBDCECEFCA
FFCCB->ACABDADEEC
ADDAE->BECBEBFEFA
EFFBC->DFEDEACDEF
ADEEC->EDCBBFDCEF
BFDAB->CDABCEFEEC
AEDAC->FBFAAEBCFD
DDCBC->AFCBFDAFDE
ADFCD->DBEFCADEAE
DFCDB->CEABDECBDA
EFDEF->CBEDFADCEA
FEFAD->ADFABCBCAE
FCEEE->BEDEDBFABF
EDEBC->ADEFCBAFFD
CBEFC->ABAFBAEDAF
BFEAD->CEABADBCFC
ACDAB->CFDECABCEC
BEDCD->EDFACEBAAE
DFFCF->AEABADBABC
BABFF->ACFEECEDCB
ECADF->BABADBEFCA
FDFAA->BECBDCFEDC
BCFEC->DEBADCDCEF
DBCCC->FACDAFDEDA
BBAEF->EDCDFBFABC
FAADE->BCBCDCEFCB
BCDEE->ACDECAFABF
CCEBB->EBDEDBCDCF
DEDDC->EBFAAEEFDE
FAECF->BCBCADDEBE
AEEEB->DBDCBADCFE
DDCFB->CECBDEABAE
AAAEE->DCBCDCFABA
ADCDC->BECBDECBEB
DEEDB->EBFAFBEFEC
FFCAA->CAEDFDFEDC
DDBDB->FCCBDACBDA
DBDCF->BACDAEDEBC
EFBFF->ADABAEEDAB
DBCBC->FCAFFECDAF
CABDA->DABCECEFCD
FBEBF->BCCDBFCDCB
FDFDF->ADEFCAEFCA
FCEAA->BEDEDBFEBC
BBDEE->DACDCAFABF
DAFCE->FAFEBEDEDB
BEACA->EDFAEDBACD
BBACE->ACAFBCBAFB
BECFE->ECDCEFEDAD
EAFCB->FCFEABDEED
DBAEB->FCAFCFDCAE
FCEDB->CBBABACBEC
ACADC->DBDEDCEFBD
FFDDD->ADABEBEFEA
DDDBC->FACBFCAFFE
BEDDC->AEDCFACBFD
CACCA->FEBCAFDEDC
DCAEF->BADEDCFADC
FDCBE->BECBEBCDBF
CCDED->FEBACEDCFC
FCFBE->CBBADCAFBF
ACFAE->FBDEABFEAD
CBDEB->DECDCAFAED
DCDFF->CEBAAEABAD
EAFEF->BABCBEFADC
DFEAE->AEABFAFEFA
CFFBC->EFEDEACDEF
CACFC->DEBCBFABEF
EFCEB->BAEDAFDCEC
AFAFD->BCEDDCABFC
BFCDC->DAEDBFEFDA
EDFCF->CBEFCADEBC
DDBDF->AFCBECEFCA
DCFCE->BADEBCDEDB
EFEAA->CBEDABFECF
ADEBC->BDCBDFAFFD
DFEBD->FAEDBFCDAE
BADEE->ECFEAEFABF
ECCBD->ADDEAFCDAE
AABFF->CDBCFEABAD
ACCDC->EDBAFECBFD
AEABE->BCDCEDAFBF
ECBCC->FADEEDBAEB
EDFCD->BFEFCADEAE
CDCDE->FECBFDCBFC
DBDCB->CEAFEABACF
CBBAA->FECDEDBCDC
DAEAC->AFBCADBCBF
DFADD->FAEDFBEFEA
EEDAF->DBFAEBFEAB
BDFEA->CFCBACFADC
CDDBE->FDCBEFCDAD
AFDDA->CDABFCCBFD
DFBEE->FCEDFEFAFB
BBBCA->CFAFCFBABC
FADCC->CAFEFCBAEB
FECCE->CBDCFDBAFC
AFACB->DCABEDBADE
ACDEC->EDBAEFDCEB
DFCCB->FCEDBFDECF
AEADE->DBDCBECBBF
AAFFE->BEFEABEDAD
BFAEB->CFEDBCDCAE
CEEFC->FDDCBAEDAF
ECDCD->ADDECADEFC
AAEAF->DBFEABFECA
FEDDA->BEFACECBCD
EFEEC->BFEDBADCFD
BDDBA->CDEFEAAFBE
ADEDF->DBEFBFEFCA
FBFEF->ABAFABDCCB
CEAAD->AFDCBEFEFA
EEFEE->ABDCEAFAFB
ABABD->FBCDDCCDBA
EBDAD->FACDCABCFA
CBFEA->FECDBEFAED
BEDAF->CFDCEFBCCB
FCFDA->CBBADCEFCD
BFFFC->ECEDCBEDAF
DDFDB->AFCBCBCBEC
CFFCD->EFEDEADEFA
DBAAD->EAAFBEFEFA
CEBCD->BFFAEDBACE
FFCEC->EAABDEFADA
CECAF->FDDCEFBCEA
FAFDF->BCBCEAEFBC
CDFDD->EBCBDCEFEB
FBBAD->CACDCFFEFA
EFACC->DFEDDCDEBD
DABBE->CABCECAFBF
FADEF->ADFEFADCEA
BCBBB->CDDEEDCDED
EDCAD->ADEFBDFEFA
EDCFE->FCEFFDEDAB
ADDCF->DBEFEBDEAB
DBDEE->FCAFBADCBA
BFAAB->CEABDCBCFE
FFFAF->ABEDEABCCB
FCCFF->DEBADEABDC
BCFAE->ACDEBEBCDF
DEFFE->AFDCEAABBF
CBDFD->FECDBAEDFA
ADCEA->CDCBEBDCED
EDABE->CDCBDCCDBF
AFAFB->DBEDBCEDFE
CCFDA->FEBADCEFCD
BEEEC->AEDCBADCFD
CACEE->DFBCFEFADF
CBAAE->FDAFCDBCAD
CDACE->AFEFCDBABA
EFEFA->BAEDBFEDBE
CAADC->DEBCEDCBDE
CCACF->BDBABCBABC
DAEBA->AEBCBACDFB
AAEAF->DBFEABFECA
CACDF->DABCFDCBCA
EABBB->DFFEECAFED
DCDED->BCBAFCDCFC
DFAFB->AEABDBEDCF
CBEEA->DECDADFAFD
EEACE->FCFACDBABA
CEFED->FEFACBDCAE
DAEBC->EFBCDFAFFD
CEDAA->DEFAAEBCBE
FCEBC->CADEBFCDFD
DAAAF->BAFEBEFEAB
EDCCB->FCEFFDBADE
EEAFA->BFDCBEABCD
EBACE->ABAFCFDEDB
FFBDF->ADABDECBCB
DBDFE->FACDBAEDAB
CAEFF->DABCBAEDBE
DFEAB->AFABADBCAE
AABFE->DCBCFEABFA
EDCAA->CBEFDEBCED
CFFDA->FDEDCBCBED
BFCAB->CFEDFDFECD
DDABB->AEEFCDCDED
FADCF->DEFEFCBADC
FCCBA->DCBADACDDB
AFDCB->DBEDFABAEC
BCFAC->FEDEBCBCAF
EAEAC->BABCBFBCFD
FCACC->ADBABCBADA
EECCB->BFDCEFBAEC
EECAB->FADCEBFEED
AFABA->EFABDCCDFB
ABFBE->FBCDEACDFA
CFFCC->ABEDABDEAF
CCCCC->ABDEFDBAFE
AEEFB->CFDCDFEDFE
BACDD->CEBCFECBFC
ACADA->CDBADBEFCD
FFFCA->ECEDABDEFB
DDABA->FCCBFDAFDC
EEDFD->BFDCFAEDAE
FFBBC->CAEDCFAFFD
DABEB->EBFEECDCEC
DBDEA->EBCDAEFACF
DFBAE->AFABEDBCAD
DACFB->EBFEDFEDED
FDEAF->DECBFCFEAB
EACBF->BABCFECDBE
EEDBE->FBFAFCAFDB
AECDB->CFDCEBCBDA
ACBBC->DCDEDACDBF
DCFEB->AFBADCDCEC
AAFBE->CFBCCBAFBA
FFFBE->CAEDCBAFBA
DEBBA->FCDCAEAFDC
BBCDE->DACDBFEFAD
DFBED->FAEDEDFACE
DEEEE->AFDCADFACB
BEECD->ACFAFBDEAF
CEFAC->FDDCABFEAF
ECEDA->CBDEBFEFCD
AAABB->DCBCDCCDED
DCCEE->AFBAEBDCDF
CBACA->FDAFCDBADB
BDAEF->CFCBCDFADC
BFABA->EDABEDAFCD
BEFCC->DEDCCBBAEB
FBCEC->ABAFFDDCEF
FABBF->ABFEEDCDBE
ACEAC->BEBAFBBCFE
BEBEA->CDFADADCED
ACCAB->CDBAEBFEED
FFFFB->ACABEAABDE
BFAAF->EDABEDFEBC
FFEEF->DEEDBADCEA
EBAEB->ADCDDCFAEC
FDEDB->DCEFBFEFED
EECFE->BFDCEFEDAD
ADBDD->BECBCDEFEA
BBAEC->ECAFCDFAEB
CDBFE->FDCBEDABDF
FBABF->CACDBCAFBE
FEFAD->ADFABCBCAE
CEAFB->DAFACDABFE
FBEAD->CBAFBABCEB
FCEAE->CBBABABCBF
CAEAE->DFBCBFBCBA
FFAFB->CAEDBCEDFE
ACEDC->FBDEABCBFD
DCCCE->FCBAEBDEDB
CCDAF->FEBACEFEAB
AFAAB->CFABEDFECD
DCFDB->CEBABCEFDA
FEDAB->CBDCAEBCEC
BFAAA->DEABEDFEDC
BFFEB->ECEDCBDCFE
EFFDB->FCABACEFEC
DDBCD->EFCBDADECA
FBDEB->DCAFEBFACD
EFBFF->ADABAEEDAB
DDCFE->CAEFDAABBF
BFCFF->ECEDFDEDCB
ACBDE->DCDEDACBBA
CACCC->DFBCFEBAEB
FFBBF->DEEDECAFBC
FAAFC->CAFEBCEDBF
FEFBE->ADFABCCDBF
ADDBB->DCEFAFCDED
CCEEB->DEDEDBFAED
EFBCA->BAEDEDBADB
FCCAB->EADEDFBCED
ABFEE->BEAFABDCDF
CDDEA->EBCBCEDCED
CCBED->BFDECFDCEF
CDBCA->EBCBDADEFB
AFFBA->BCEDEACDDB
CAECF->BDFEFADEBE
EFDED->BFEDAFDCAE
FEEFA->BCFABAEDFB
DCFDF->BADEBCEFDC
DEDBC->AFDCAECDFD
CACCA->FEBCAFDEDC
BDEDA->CFCBBFEFCD
FECAD->EAFADABCFA
AFEEB->CFABDFDCDE
BBDFE->ACAFEAEDFC
CEBDA->FEFACFCBCD
CADDD->FDFEAEEFEB
DCCBF->EBDEDFAFAD
DCBDF->CEBACDEFBC
FEBFD->EAFACDABCE
ABDDA->BCAFBAEFCD
CBADE->FECDFBEFAB
DDEEC->EFCBBADCFD
EEBFA->FCFACDABFD
ADDBC->FBEFEAAFEB
FEAAF->BCFAEDFEBC
FDDCF->CAEFEBDEAB
CBFDC->FDAFBCEFBD
BCEBC->ECBABFCDFD
ACEDF->BEBAFBEFCB
CCFDD->FDBACAEFEB
FDFAA->BECBDCFEDC
DDCDC->EBEFFDCBFE
DCFEF->EBDEABDCCB
BCADB->CEBABECBCD
AFFAC->BDABEABCBF
FDBEE->ADEFEDFABA
FBCFE->CBAFEBEDAD
CCDFE->FEBACEABBF
FBFFF->ADAFABEDEA
FAAEA->BEBCEDDCBE
CDBDF->FECBECEFCA
DFBAA->FCEDFEBCBE
AFBFD->DCABFEABAF
CEDCB->DAFAAEDECD
BDECE->ECEFBFDEBF
AEFAE->BCDCCBFEBF
FDDDF->ACEFCECBAC
EEEBC->DFDCFCAFFD
DFFDD->BCEDABCBCE
EFCCF->BAEDAFDEBC
AEBCA->CDFAECBADC
BBCFA->DACDBFABDB
DFEBE->FCEDADCDAD
FFFAD->CAEDCBFEBA
CFCEC->EFEDBFFADE
ADEED->DCEFCBDCFA
EACDA->CBFEDAEFBC
CABFA->EBFEEDABED
CCCDD->FEBAEBCBCE
DBBFB->FCAFACABDE
EECCF->ABDCFDBACA
ADBBD->DCEFDACDCA
BFACC->DEABEDBAFE
CDFBA->BDCBDCAFCD
DBCAD->EBCDFDFEAE
EFBEC->BAEDEDFAEB
CEDFC->DFDCEBABDE
CFDED->FDEDFADCAE
DFEAE->AEABFAFEFA
BBCFE->EDCDAFABBF
AAADB->FDFEBCCBDA
BBACD->EDCDFBDEFA
EEEDA->BFDCBACBED
DCFEB->AFBADCDCEC
BAAFB->CEBCFBABDE
DBECE->BACDABBABA
EFCAF->ADABEBFEBE
ADFEF->DBEFCADCAB
FACFE->BCBCAFABBF
DDFBB->FCCBDCAFED
CDEAE->AFEFBFBCBA
BAACC->EDBCDCDEBD
FDCEE->ABCBEBDCDF
ECABA->BFDEDCCDFB
BCEFC->FEDEBFEDEB
FBFED->CACDCBDCAE
AFCFE->CFABFDEDAB
CFEAA->DEABBABCFB
ECAAF->BFDEDCBCEA
EACAA->FBBCFEBCDC
CFBAB->FDEDCFFEEC
BFAEC->FEABDBDCEF
DAACD->FAFEFBDEFA
AEFDA->BEDCABCBFD
BFDEB->DEABFCDCAE
FAFEA->BCBCEAFACD
ACCCD->FBDEDFBAFC
FBAEF->DEAFDCFADC
AEDCD->DCFACEBAAE
CBFAF->FDAFBCBCEA
BAABB->FABCFBCDFE
CDBFD->EBCBDAEDFC
CCCDF->EBDEAFEFCA
CECCC->DAFADADEDF
CCFBE->FEBADCAFBF
FFCDA->CBEDAFEFCD
FDFCD->CAEFCADEAE
CCAAA->DADEBEFEBE
CDBEC->DFCBCFDCDE
EAEDD->FCFEFACBCE
EAFEF->BABCBEFADC
DADEA->EFBCFCDCED
BFAAF->EDABEDFEBC
CAEBB->DABCBACDED
FCBAB->CBBAECFECD
EDAAA->BFEFCDBCDC
FFABC->BEABFDAFDA
DBBFD->EBCDCFEDFA
CFEDE->FEABDFCBBF
ECFEA->CBDEBCFAED
FEBFE->BEFAECEDAB
CAEFF->DABCBAEDBE
AFEED->BEABBFDCFA
CCEAE->FEBABABCBF
EEFFB->BFDCABEDFE
FCEBA->BCDEDBCDBC
ABFEA->EFCDABDCED
FAFCF->ACBCBEDEBE
FEFEF->ACFACBDCEA
FDDAD->CAEFEBFEFA
FDCBF->CAEFDECDEA
BCFDA->EDBADCEFCD
FACEC->CBFEFEFAFD
EDFDD->ADEFDCEFEB
CBBFC->FDAFEDABFD
ECEBE->FADEDBCDAB
FFDBA->CAEDFACDFB
BBCDA->CFAFFDCBCF
CAADB->DABCBECBCD
FBCEA->CACDFDDCBE
BFADF->ECEDBCCBDC
CEFAB->EBDCCBFEAC
DADEA->EFBCFCDCED
EFEEE->FAEDADFACB
DEDCA->AEFAEBDEBE
CEDCA->FDDCFABADB
EEABF->BADCDCCDBE
EAAAE->FCFEBEFEFA
FFEEC->CAEDABDCFD
BFEDE->EDABDFCBBF
DADAD->BCFEFCFECA
BEEBE->ECDCBACDBF
FFEDD->ABEDADEFAF
DFCEB->AFABDAFACD
AEABC->DBDCBEAFFD
DEFEF->EADCBEFADC
FABBA->CBFEACAFBC
CADCE->AFBCFABABA
AAFFA->EFBCADABCD
CBDCA->FECDBADEDC
BBCCC->DECDAFDEDA
AABDC->DCBCFEEFDE
EFBCF->CBEDCFBABC
EFFAA->BAEDBEBCED
CCBDC->DADEECEFDE
DBFEF->BACDCBDCEA
EABEF->ADBCAEDCAB
CCDBB->EFBACEAFCF
BADBE->EDBCAECDAB
CAECD->AFBCBABACE
DFFBD->EAEDCACDAE
FBECE->ABAFABBABA
ECDBE->FCDEAECDAB
EBAAF->DBCDBCFEBE
CBFCA->EBCDBEDEFB
EFDBB->FCABEBCDCF
BDBDF->EDEFECEFCA
DBFBD->BCAFCBAFCE
EBBBD->ADCDFECDAE
AFBCA->EFABEDBADB
AFCEB->DCABFDDCEC
EFFEF->ABEDBEFADC
BAEDB->CEBCBFEFED
DDABC->EBEFBCAFFE
DCBEC->AEDECDFABD
AFDBB->FDEDAFCDED
CDFBF->FECBCBAFAD
DDDBF->EBEFEAAFAD
FFBBD->ADABDECDBA
DAAED->EFBCEDDCFA
AEBDD->DBDCECEFEB
CCFDA->FEBADCEFCD
DEBAE->FADCFEBCBA
EABBD->BFBCECAFEB
AFEFE->BEABBFEDBA
BFBAE->EDABFEBCBA
DCFAF->EABACBFECA
BBFFC->DECDBEABEB
ACCAA->EFDEFDFEDC
BBDCF->CDCDCADECB
FBEDD->CACDABCBFC
EAEEB->DFFEFADCAE
CDEFB->FDCBFCABDE
FFBFD->CBEDEDABFC
EAEEA->BABCBFDCBE
BBCAB->CEAFEBFEED
EEEED->FADCDFDCEF
FBEFF->CACDABEDBE
FDCDA->BECBEBCBFD
FCCBD->BEDEAFCDAE
FBCDB->DCAFDECBDA
CBDAF->BDAFEAFECA
FBAEE->ABAFBCDCDF
EEAAF->ABDCDCBCEA
FBDAB->CACDAEBCEC
DAADA->AEBCBECBCD
EECFF->DBFADEABDC
DCFEB->AFBADCDCEC
BEFDE->DADCCBCBDF
EADFC->BABCEBABDE
DAAEF->CEFEBEDCAB
DAADE->FAFEFBEFAB
AAFDD->BCFEBECBCE
BDDBB->FAEFAECDCF
BDCCF->DACBEBDEBE
BAEBA->ECFEABAFCF
BBABD->ACAFBCAFBA
DADDC->FCFECAEFDA
CCCCB->DEDEAFDECD
CAFCF->EBFEBEDEBE
FCABC->ABDEFBCDBF
DECDF->AFDCFDCBCA
EBFEC->ADCDEAFADA
BEEAD->ECDCBABCEB
BDDBC->DECBFCAFFE
BBABF->ECAFCDCDBE
DCAFE->AEDEDCABDF
EDDFE->FACBCEABBF
CAFAD->EBFEBEBCFC
AEECC->DCFABABAEB
ADCFE->BECBDEABBA
FACFD->CBFEFEABFC
DBCEF->EAAFEBDCCB
DAFCB->EBFEABDEED
ABDCA->EFCDFCBADB
AEEAC->BDFADFFEDF
AEDEB->CFDCFCDCAE
DAFDE->AFBCEAEFAB
FCDEA->CADEAEFACF
AAFCA->DBFEBCDEFB
EBADC->FCAFBCCBEB
AAFBB->EDFEBCCDED
BDCFB->DECBFDEDCF
FEEFC->CADCBAEDAF
ADAFF->DBEFCDABCB
EDABC->FCEFBCAFFE
ACCDB->FDBADECBDA
CDBCF->BDCBDADEBE
EDBFF->DBEFCDABDC
BDFFC->FEEFCAEDFD
EADAD->BABCEBFEFA
AEFDB->EDDCABCBDA
AFCDD->DBEDFDCBEF
AEDFF->BCDCFCEDEA
AEACB->CDFAEDBADE
CBAFE->DACDDBEDAB
EAABA->CBFEDCCDFB
EABCC->DFFEECBADE
BBBED->FECDCFDCEF
AFFDC->EDEDCBCBFD
DBBFE->BACDCFEDAB
DEFDF->AEFABECBDC
EBDAE->CDAFAEBCBA
FBFAA->ECAFCBFECF
CCCDB->DADEDFCBCF
CADDD->FDFEAEEFEB
FACFD->CBFEFEABFC
CFCBD->AFABDECDCA
DADAF->EAFEBAFEAB
CEBCA->BDFACDDEFB
CDEAE->AFEFBFBCBA
DFDBF->EAEDEBCDCB
CACCA->FEBCAFDEDC
FAEDC->CAFEBACBFD
DDAEF->EBEFBCDCCB
ADFBF->DCEFDCAFBC
ECEFB->FCDEBFEDEC
ACFBA->BDBACBAFBE
FFADB->DCEDBCCBDA
ACEBD->BEBAFBCDBA
CBDCA->FECDBADEDC
EDEBC->ADEFCBAFFD
CCABE->BDBABCAFDB
ABEAD->DCCDBFBCFA
AAEEF->BCFEADFAEC
FBDCF->ABAFEABACB
FDAEF->ADEFCDFADC
EBCBE->FCAFFDAFBF
CDAEC->EFCBEDDCEF
FAAEA->BEBCEDDCBE
AECFB->DCFAEBEDFE
DBBDF->EAAFECEFCA
BECDD->CFDCDECBCE
DADCA->CEFEFABADB
FEBED->BEFAECDCFA
CCEFB->DADEABEDED
BCDAE->CDDECABCBA
CDFAF->BDCBDCFEBC
CEBFA->DAFACDABFD
ADCCE->FBEFFDBAFC
ACBAA->BCBACDBCED
BCEAA->DADEDBFEBC
BDEEB->CFCBBFDCEC
ECDDB->FADECAEFCD
DBEFF->AECDABEDBE
BABCE->ECFECDDEDB
CEBAA->FDDCECFEDC
ADDBA->BCCBCEAFBC
BDDFF->EDEFCEABAC
BFCEA->CDABEBDCED
DCFCF->AFBADCBABC
CFFAD->FDEDCBFEBA
CCAAA->DADEBEFEBE
CADEF->DABCFADCEA
CCFAD->FEBADCFEAE
CAEAA->DABCBABCFB
CFDEF->DEABCEDCCB
DADDC->FCFECAEFDA
DDDAE->CAEFAEBCBA
BFEEF->EDABDFDCCA
BCEDE->ECBABFEFBF
CEFFD->AFDCABEDFC
DDBDF->AFCBECEFCA
FCAAB->DCBABCFEED
EFFDC->FAEDEAEFFD
EDDCE->FBEFCEBAFB
FFDDB->ACABAEEFED
ADEFB->DBEFBFEDEC
CAFBA->DABCABAFBC
CADFC->ABFEFCEDBF
FDAEB->CBCBEDDCEC
EEDCB->FCFAAEDECD
BCABC->FEDEDCCDAF
DFCAB->EBABDEBCAE
FBECC->CACDABBAEB
BDBEA->EDEFECDCBE
FCFFF->CADEBCABCB
EFFCF->BFEDABDEBE
FCAFA->DCBABCEDDC
EBCCB->BACDAFDECD
FEFDC->CBDCEAEFFD
CEDAF->DAFAAEBCAB
CAFEC->FDFEBCFAEB
DAEDC->AEBCBACBFD
FCEBD->ADBAFBCDBA
EEAAC->FCFACDBCAF
EBEEA->CBAFABDCDC
FFBDA->DCEDCFCBCD
DBFDA->CEAFABCBFD
CCCAD->FDBAFEBCAE
CEEAD->FDDCBABCEB
CFEBF->FDEDABAFBE
EAFBC->BABCBECDBF
ECDDE->FBDEAFCBDF
BADCD->CFFEFABACE
ADBAF->DBEFEDBCEA
CBECF->FECDBFDEBC
DFEBB->EFABBFCDCF
FFBEA->ECEDECDCBE
BCFCD->CFBABCDECA
AEBDD->DBDCECEFEB
BDACC->ECEFCDBAEB
CDBCF->BDCBDADEBE
DEFAF->AFDCEABCCB
FACFE->BCBCAFABBF
DDDCA->EBEFEABABE
FAEDC->CAFEBACBFD
EFACC->DFEDDCDEBD
FBAEC->CACDBCDCEB
AEAEB->EDDCBEDCEC
CADED->EBFECAFAEB
BABEF->DABCFEFABC
CCECA->FEBABABADB
BEDBD->ACFAAECDAE
CEECF->FDDCBABADC
DFFEC->EBABACFAFD
CEBEB->FEFACFDCDE
DFDDA->CEABEBEFBC
DBFFC->FACDBEABEB
CDAAE->BDCBFDFEBA
AECFD->CFDCEBEDFC
CBDBE->AFCDAECDAB
BCFBA->DADEBECDDC
FCEDF->ADBAFBEFCB
AEECB->EDDCBABAEC
ADEAC->DBEFBFBCFD
BFCAF->DAEDBFBCAD
BFCDA->EDABFDCBCF
BDEAF->EDEFBABCBE
FAACC->CBFECFDEAF
EBBEE->CDAFCDFACB
FACDA->DCFEDAEFBC
EEEFB->ADFACBEDCF
BFADF->ECEDBCCBDC
ECFBE->CDBABECDAD
DABFE->AFBCFEABFA
DAEBB->EBFEFACDFE
EEFCA->CBDCABDEFB
FBBCA->ECAFCDDEFB
AFCBC->BEABDECDBF
BDBEB->DECBECDCEC
FCBDB->CADECDEFCF
BDDDD->EDEFCECBEB
EDAEC->DFCBCDFAEB
EDDCA->FCEFEABABE
ECADE->FADEFBEFAB
EAEAA->FCFEFAFEBE
CBEEE->FDAFBFDCBA
DFBAD->EFABDEBCAE
CEAFB->DAFACDABFE
CCFFD->EFBADCEDFA
ECADA->DFBABCCBFD
DBEAB->EBCDABFEAC
ECDFD->FADECAEDAF
DACEE->FCFEAFDCBA
BFBAB->ECEDCFFEEC
ECAFB->BABADBEDCF
FCCBB->CBBAEBCDED
BFFAC->DAEDEABCBF
AFAEA->DBEDBCDCED
AAFDB->DBFEBCEFDA
CEBFA->DAFACDABFD
EFEDE->CDEDBACBDF
CCEAD->AFDEBFBCFA
BFEBE->DAEDADCDAD
AFDFF->BEABEBABAC
EFFEE->CDEDABDCDF
DABED->BCFECFDCEF
BAECF->ACFEFADEBE
EBFDA->DFAFABCBFD
BBEFC->EDCDBFEDEB
EEFCB->BADCEADEEC
EBFAA->FCAFABFEFB
BCDBC->DADECACDEB
DCCED->EFDEAFDCFA
CAEAD->EFBCADBCFC
EEBAF->ADFADABCEA
CAEEF->DEBCDFDCCA
EFAEA->BFEDBEDCBE
EAADB->FCFEBECBCD
FCBBE->BEDEEDCDBF
FCFCA->BCDEBEDEFB
BFFBB->FAEDABAFCF
CAEEE->DABCBADCAD
BFFAB->DEABCBFEAC
AABCB->DCBCFEDECD
CCEAA->EBDEDBFEBC
FACBE->ABFEAFCDAB
FABFC->ADFEECEDFD
BADAC->FEBCFAFEAF
CEEFA->BDFAFBABDC
BACCD->ECFEDADEFA
DAFBA->EBFEABAFBC
ECADE->FADEFBEFAB
FBCEE->BCCDAFDCBA
BACAC->AEFEFDFEDA
CDBCC->DAEFCFBADA
FDACA->BCEFDBDEDC
DDAED->EACBDCFACE
ABDAC->BEAFEAFEFE
ACBEB->CFDEEDFAEC
AAAFC->DBFEDCABFD
DBDFE->FACDBAEDAB
BABDE->DABCFEEFBF
FADAB->ADFEFAFEED
CAABD->EBFEFBCDCA
DEFFC->EBFABCABFD
CAECE->FEBCADDEDB
EBDFF->ADCDCAEDAB
EFFFD->FCABACABAE
BAABF->CFFEBEAFAB
EBAAD->ADCDDCBCAE
AFFFC->DBEDCBEDAF
AFEFC->BDABADABEB
EAFEE->FAFEABDCDF
EFFAA->BAEDBEBCED
DCBED->EBDEECDCFA
EFDFA->CBEDFAEDFB
EFEBB->FAEDADCDFE
ADACA->CDCBFDBADC
FEFAE->ABDCCBFEBF
CECDA->BDFADAEFBC
FECDC->CADCEFCBFD
DDABA->FCCBFDAFDC
DCDCA->EFDECADEBC
ACEAE->DCDEBABCBF
AAACE->CFBCEDBAFC
DDBBE->FACBECAFBF
FFDCA->BEABCEBABC
EDCBD->ABCBFDAFEB
FACBD->ADFEDFAFCE
BFECF->DAEDADDEBE
DCBEB->FCBAECDCEC
FCDDC->CBBACECBDE
ADFDB->DCEFDCEFED
AAAAC->BDBCFBFEDF
FDBEB->EAEFCFDCDE
DAFFE->CABCABEDAD
BEACD->ECDCBEBAAE
EDDED->FACBCEDCFC
DBFAF->AECDCBFECA
EEEEA->FBFADFDCBD
CFFAD->FDEDCBFEBA
FABBA->CBFEACAFBC
FEBCF->DEDCEDBADC
CEBFA->DAFACDABFD
BBADB->ECAFCDCBDA
ADBBF->CFCBDACDEA
ACBBA->BEBACDCDDC
EBDEE->FBCDBADCBA
FDDCB->DCEFEBDEEC
BBCBD->ECAFDECDCA
EFFAE->FCABACBCBF
CFEED->BFABFADCFC
FADDA->CBFEBAEFCD
EFDEF->CBEDFADCEA
DADCE->BAFEFABABA
BBFFC->DECDBEABEB
CCFDC->DFBACBCBFD
ABBEC->BEAFCFDCDE
ECDEA->BFDEAEFACF
ECBBD->ABBAECAFEB
CFDCB->FDEDFABAEC
FDBEC->BECBDADCEB
FEAAD->ABDCEDFEAE
ADEAB->CFCBBABCED
ACBBB->EDBADECDED
FBAEB->ACAFBEDCEC
AECCC->BEDCEFBAEB
ECEEE->FBDEBADCAD
BEAFB->CFDCBDABED
BAFEC->ECFEBCFAEB
EEDDF->ABDCAEEFCA
BEFEB->CFDCCADCEC
FCCED->ABDEAFDCFA
EFDEB->DFEDFCDCAE
CDDCC->ABEFAEDEDA
BFCBD->FEABEFCDBA
ECFDE->FCDEBCEFCB
BBDCA->EDCDBADEDC
FECCF->BCFAEBDEBE
AEDDA->BDFAFCCBFD
ABFFC->FBCDEAABDE
CDFEA->DAEFBCFAED
FCBFE->ADBACDABBA
EEFEC->FADCCBDCFD
FDDFE->ABCBCEABBF
AEAEB->EDDCBEDCEC
EFBDF->DBEDECEFCA
BBEAC->FECDABFEFE
BDADF->CDEFBCCBDC
EAAAB->DFFEBEFEEC
EAEDF->BABCBFEFCA
BADFA->CFFEFAEDFB
FFCAA->CAEDFDFEDC
ACDFF->CDBACEABAC
ECFCA->DFBABCDEFB
BCDAA->DEBACEFEBE
AFBEF->DBEDCFDCCA
EBBBF->DBCDCFAFAB
FAAEE->CBFECFDCDF
EABAA->DFFEECFEDC
BAAFD->CFFEBEABEB
BDDBE->ECEFEBCDAB
BAAAC->DABCDCBCAF
DADCB->FCFECADECF
AACEC->DCBCAFDCEF
FCBEB->ACBAECDCEC
AECCF->CDFAEBDEBE
DEFAD->EBFABCBCAE
FFCCB->ACABDADEEC
CFEEE->AFABBFDCBA
ABBDF->CFCDFEEFCA
ADCCE->FBEFFDBAFC
EBFEE->FCAFABDCDF
ACCFD->BEBADAABEB
DDBAF->AEEFEDBCEA
BDBBF->DACBDACDEA
CECBF->EBDCEBCDBE
EDCEB->ADEFBDFACD
CFFAD->FDEDCBFEBA
ACADE->BCBABCCBBA
BFBEA->CFEDCFDCBD
DDBDC->AEEFEDEFEB
BACAF->ACFEDFBCBE
ECFDF->CBDEBCEFDC
CDAEB->FECBEDDCEC
EDBEC->ADEFDADCEB
BCDAE->CDDECABCBA
FCCEA->BEDEAFDCBE
EEBEB->BADCFEFACD
ADBBB->FDEFEDCDED
FEACD->CADCBEBAAE
BFBAA->DAEDFEBCBE
AEABC->DBDCBEAFFD
FBCEA->CACDFDDCBE
DBDEC->AFCDBADCEF
EEDBA->FCFAAECDBC
CBDFC->DECDCAEDEB
ECCFD->FCDEDAABEB
AEACF->BCDCEDBACA
AFCBC->BEABDECDBF
BCBFA->EDBAECEDBC
AFDDF->DCABFCCBDC
FAFAD->BEBCCBFEBA
CCEDE->FDBAFCEFAB
EADDD->BFBCFACBFC
BDDAE->CFCBEBFEFA
BAEBA->ECFEABAFCF
AEBBF->CDFAECAFBC
ACEBD->BEBAFBCDBA
BBEEF->CFAFABDCEA
FDAFD->EAEFBCEDFC
ECFDC->ADDEBECBEB
EABEB->FCFEECDCEC
DADDA->AFBCAEEFCD
CCBAC->EFBAECFEDA
EDBBD->BACBECAFEB
ADEFC->BECBBFEDEB
FFDBF->ACABAECDCB
CADFE->DFBCEBABBF
DCACC->EBDEBEBADA
FBBCF->CACDCFBABC
CBDEC->ABAFCEDCEB
ABECF->DCCDBFDEBC
EAADD->BABCFBEFEA
EDAAC->FACBFDFEFD
DECCA->FCDCEBDEFB
DDDDC->EFCBCECBDE
EFDBB->FCABEBCDCF
EEDDE->CDFAEBEFAB
FAAFC->CAFEBCEDBF
FAAAD->CAFEBCFECA
CCFFB->DEDEBEABAE
ABFEA->EFCDABDCED
DCAAB->EFDEFBFEEC
DCFDB->CEBABCEFDA
BFACE->ECEDBCBAFB
EEBFF->BFDCECEDCB
FBABD->EACDDBAFAE
AFCEB->DCABFDDCEC
BBEEE->ECAFBFDCBA
EFCED->ADABEBDCFC
EDFAA->FBEFCBFECF
BFACF->CFEDBCBABC
BCECA->EDBABABADB
BCFAF->DADEBEBCCB
CEFBB->EFDCEACDCE
ABBCC->DCCDEDBAEB
ADEDC->DCEFCBEFDE
CACEF->FDFEDAFABC
EEDDC->FCFAAEEFDE
FBEDB->EACDFACBDA
ACBDB->DBDECDEFCF
EFCAE->ABEDAFBCBA
AFDCC->BEABEBDEDF
FCDCB->CBBACEBACD
BABFB->ECFECDABAE
BEBAD->EDFAECFEAE
DCDDA->EBDEFACBED
CEBCF->FEFACFBABC
EFAED->BAEDFBFAAE
DBFCD->EFCDEADEFA
EFCAD->BAEDAFBCFA
FBDAF->BCCDBAFEAB
FFAFA->BEABFDEDBE
AAFBA->BEFEABAFBC
DDFCA->AFCBCBBADB
BFEBE->DAEDADCDAD
AEBCF->DCFAECBABE
DEAAB->AEFACFBCAE
EEADE->BFDCBECBBF
AEADB->DCFAEDCBCD
DCFDB->CEBABCEFDA
EEBED->ADFADADCFC
FABAC->CAFECFFEDF
BEDAB->FAFAEBFEEC
DBABE->FCAFCFCDAD
DAEDA->CEFEFACBFD
AEAEB->EDDCBEDCEC
ECCDE->ABBAEBCBBA
BBBBD->CEAFECAFEB
FADAD->CBFEBAFEFA
CAAFB->EBFEFBABDE
EBAFD->BFCDBCEDFC
BAEFD->CEBCBFEDAF
EFDFF->DBEDAFABEA
AADEA->BCFECAFACF
ACDDF->DBDEAEEFCA
CBEED->EBCDBFDCFA
BFCAA->ECEDFDFEDC
BBBFD->CFAFCFEDFA
BEBFE->DADCAEEDBA
DCAFB->AFBADBEDCF
BECCD->FEFADADEFA
DAFCC->EFBCCBBAEB
EEAAE->CDFACFBCDF
DFDED->AEABAFDCAE
FFAFC->ADABCDABFD
BFABB->DEABEDAFED
FEBCC->CADCECBADE
AFCBE->DCABFDAFBF
ABCEE->FBCDBFFABF
FBBCD->EACDCEBAFC
FFBAF->BCABFEBCAB
DFFFD->EBABACABAE
BBEDE->CFAFABCBDF
DEECD->FADCADDECA
DBEEF->EBCDABDCEA
AFFAA->EFABEABCED
DAAAD->AEBCBEFEFA
EFFDF->ADABDCEFCA
AFEEC->DBEDABDCFD
EECAE->FBFAFDFEAB
CFFCB->DEABDCBACD
CFBCC->DFEDEDBAEB
BEDAB->FAFAEBFEEC
DFFAC->FCEDEABCBF
FECCB->CADCEFBAEC
CFBAC->DAABDEBCAF
DBBED->EFCDFEFAAE
BEFCC->DEDCCBBAEB
CCBAE->FDBADEBCAD
CBABB->DECDDCCDED
ADABB->DBEFCDCDED
FDBFA->DCEFEDABED
ECDAD->FCDEAEBCFA
EBAEA->DFAFBCDCED
FADBA->BEBCFCAFCF
FFFDF->ACABEAEFBC
BAAAD->ECFEDCBCAE
DDBFC->FACBECEDFD
CAABD->EBFEFBCDCA
DDCAC->FACBFDFEDA
AFEEC->DBEDABDCFD
FFCBB->CAEDFDAFED
FDBCE->CBCBECBABF
ECFDB->DFBABCEFDA
EBBEB->BFCDCFDCDE
BECEC->DADCEBDCEB
BBCAC->ECAFDEBCBF
AECEA->EFFADEFACD
ACBBA->BEBACDCDDC
ACBED->BEBACDFAAF
AFBDD->CFABFEEFEB
AFAAA->CDABEDFEDC
EBFBF->ADCDEACDAD
AFEFD->DBEDABEDAE
EDBAE->FBEFECFEAB
DBFCB->AECDCBBAEC
AABAB->CFBCAEFECF
EAFBB->FAFEABAFCF
DCACC->EBDEBEBADA
BCBAA->CDDEEDBCDC
DBBEF->CEAFCFDCCA
AAFEA->CDBCEAFACD
EDDEC->FCEFEADCDA
CDFFC->DECBDCEDFD
FDDED->ABCBCEDCFC
AFFDE->FBABACEFBA
EBFDE->FACDEAEFAB
FFACD->BEABFDBAEB
BDCED->CFCBDEFAAE
BBBFF->EDCDEDABCB
CBABF->FDAFCDCDBE
BDAFD->ACEFBCEDFC
DDFFC->EFCBDCEDFD
ECCFA->DFBADAABCD
CAECB->FDFEABBAEC
AECCE->DCFAEBDEDB
EACCB->DFFEDFBACF
FFBDD->BEABAECBEF
EFBEA->FCABDEDCED
EDFFB->FCEFBCABFE
CEFEB->DAFABCFAEC
BCFDE->CFBABCEFCB
CCCFC->FDBAFEABFD
FFAEF->ACABDCFADC
FCCBD->BEDEAFCDAE
AFCDB->CDABFDCBED
EADEB->BABCEBFACD
EDBEB->DFCBCDFADA
CEADE->FDDCBECBBF
BACAD->FEBCFDFEAE
AEFDF->DBDCABCBDC
DEDEF->AFDCAEFABE
EDCBC->BACBFDAFDE
CDAEA->DECBFDFACF
FFFDB->ADABACEFEC
AFAAB->CFABEDFECD
EDADC->ADEFDBEFDE
BCBBB->CDDEEDCDED
ACAEB->CDBADBDCEC
FADCE->ABFECADEAD
AEADC->FBFACDCBEB
FFEDA->BEABBACBED
FCDFF->BCDECAEDAB
DAFBF->AEBCABAFAB
FCBEE->ABDEEDFABA
EADFA->FCFEFAEDFB
BEFAC->ECDCABFEAF
CFDFD->EBEDFCEDFC
FFEDE->CBEDBFEFBF
BFCFA->CFEDFDEDBC
CACAB->FDFEDABCEC
FCCDC->ABDEAFEFDE
BBCAD->CFAFFDFEAE
FAFDA->BEBCCBCBED
EDFCD->BFEFCADEAE
ECBCA->BFDECDDEFB
BFBEA->CFEDCFDCBD
DADBC->EBFEFACDAF
EDCAF->DBEFDABCAB
FAFAB->CBFECAFECF
ADFDD->CFCBDCEFEB
DFECD->BCEDBABACE
DFACB->AFABDCDEDA
CFEDE->FEABDFCBBF
DECDC->AEFADECBEB
DCBDD->EFDEEDEFCE
BDCDD->FEEFDECBCE
CDFDB->FECBCBCBEC
FABEB->ADFEECDCEC
EEABB->ADFAFDAFCD
DBBCE->FCAFACDEDB
ABBFF->DCCDEDABCB
FDBEA->CBCBECDCBE
CCCED->AFDEDAFAAE
FFDFF->ADABEBABAC
DDBDB->FCCBDACBDA
FFDAE->BEABCEFEFA
DEDDE->AFDCAEEFBF
AECCD->BCDCEBDECA
DAAEA->FCFEFBFACD
BECAA->CFDCDEBCED
BDCAD->CECBDABCFA
CDEDE->DFCBADEFCB
FBEAF->ACAFBABCBE
CCDBF->DEDECACDAB
CBBAC->DFAFECFEDA
FCDCF->ADBAAEDEBC
DDECD->EACBADDECA
CCDCA->DEDECADEBC
EBBFC->BFCDCFEDFD
ADDBA->BCCBCEAFBC
AEBAC->EDDCECFEDA
FDDCE->BECBCEBAFB
BCFEE->ECBABEFABA
BBEAA->ECAFBFBCBE
ACDEF->CFDECAFABE
CBECD->BFCDBABACE
FCFFB->DCBABCABFE
FEDFE->ADFAAEABFA
BDDFA->DECBFCEDDC
CDCCA->FDCBFEBADB
BDACE->CDEFBCBAFB
FCFAF->ACBADCFEBC
CABED->FEBCFEFAAE
ACBCF->CFDEEDBADC
ACCDC->EDBAFECBFD
ABDAB->DBAFAEBCEC
FFADC->CBEDFBEFFD
DADAD->BCFEFCFECA
FAECF->BCBCADDEBE
EFDBE->ABEDAECDAB
CBEBD->AFCDABAFBA
BCAFA->CDDEFBABCD
EABCE->BFBCECBABF
EAFFB->DFFEABEDFE
CDACF->FECBEDBACA
BFCFD->ACABDEABCE
AFEAA->BCEDADBCED
AEDEF->DCFACEDCCB
EBDAC->FCAFEAFEFE
BDDCC->EDEFCEBADA
FEEDB->ADFAFBEFEC
DDFDB->AFCBCBCBEC
ECEAF->ABBABABCBE
ADEDF->DBEFBFEFCA
DCBEE->BADECDFACB
DFAED->BCEDBEDCFA
EDBEB->DFCBCDFADA
BDAAB->CFCBCDBCFE
CBEDB->EFCDBFEFED
CFADD->EFEDDCEFAF
BEBCD->CFDCDEBACE
EFCDF->CBEDFDCBCA
CAEBE->BDFEFACDAD
FAEAF->CAFEBABCBE
ECBED->FCDECDFAAF
EFECB->FCABBFDECD
FBBFE->ABAFCFEDAB
CCAEE->DADEBEDCBA
EFAFB->BFEDBEABDE
DBABF->AECDBCAFBE
BEFCA->CDFAECDEDC
BEFAE->CDFAECFEBA
FBBAA->CBAFECFEDC
AFFCE->CFABCBBABA
FAFBD->EABCCBAFCE
BDDEC->AECBEFDCEB
CAFAF->DABCABFEBE
ECBBD->ABBAECAFEB
CBBFC->FDAFEDABFD
FAABF->ADFEBEAFAB
DAEDD->EBFEFACBCE
DADEB->AFBCAEFAED
ABDAF->CDCDBAFEAB
FABCD->BEBCAEBAEB
ADAEC->FBEFBCDCEB
DABCA->EFBCAEBADC
EFEFE->FCABBFEDBA
DDBCD->EFCBDADECA
EDDED->FACBCEDCFC
CABFE->FEBCFEABFA
BEBBC->AEDCECAFDE
BBEFE->DACDADABBA
FABFF->BCBCFEABAD
FEBFF->CADCECEDCB
BAACE->DABCDCDEBA
ADCBF->DBEFDECDEA
ADAFD->FBEFBCEDFC
DDBCA->FCCBDADEFB
AEDCA->DBDCFABADB
DADBC->EBFEFACDAF
FEAAF->BCFAEDFEBC
DCEBC->AEDEBFCDFD
EFCAB->FCABDEBCAE
FFCBE->CBEDAFCDAB
EEDAF->DBFAEBFEAB
CECDE->AFDCEFCBDF
AEEFB->CFDCDFEDFE
AEBBF->CDFAECAFBC
CDFBE->AFEFCACDAB
BBBCE->DACDFEDEBF
FEBBA->BEFAECAFCD
DEBEE->AEFAEDFABA
EEBAA->BFDCECFEDC
CFEBA->DAABBFCDBC
EACFB->FCFEDFEDED
EBEDB->DFAFABCBEC
DCBAA->EFDEEDBCDC
ECBFF->CBDECDABDC
CFDDA->BDABEBEFBC
AEDBB->EDDCFACDED
DBAFA->AFCDFBABCD
DFAFD->EFABCDABFC
DFEEA->CEABBFDCBE
CAFBF->FDFEBCCDBE
DDCCB->EBEFFDBADE
FAFDD->ABFEBECBCE
ABDEE->CFCDCAFABF
ADBFB->DCEFDAEDFE
DDEAE->BAEFBFBCBA
DFCBE->AFABDACDFA
FEBFC->CBDCFEABEF
AAEBB->FDFEBACDED
BFDAA->CFEDFAFEFB
EACBE->FAFEDFAFBA
FAFBA->ECFECBAFBE
DFABE->CAEDBEAFAB
CEBDD->FDDCECEFEB
EADAD->BABCEBFEFA
DAEBD->BCFEBACDBA
AEACB->CDFAEDBADE
DDFBC->AEEFCACDFD
BAFEC->ECFEBCFAEB
ACCBB->DCDEBDAFCF
CCBFF->DEDEEDABCB
BCCBB->FADEFDAFED
ACCCE->CFDEAFDEBF
AEBCF->DCFAECBABE
CDFEF->FDCBCADCAB
FDEEF->ACEFBADCEA
BACFA->ECFEDAABCD
ADBEF->BCCBDADCCB
EFFBC->DFEDEACDEF
AABEA->DBFECDFAFD
ABDAD->BCAFBAFEFA
FDAFC->CBCBEDEDFD
CFABF->DEABFDAFCB
DDEDC->AFCBDFCBDE
ECDCC->DFBAAEDEDA
ACBDC->BEBACDEFFD
ADABE->DCEFDBAFAD
FDCCC->ABCBEBDEAF
ECCFC->BFDEDAABDE
ACABF->CFDEFBCDEA
DFCFD->FAEDAFABEB
DCDCC->FABACEBADA
BFDAF->ECEDFAFEBE
ECEDF->DBDEADEFDC
FEAFA->CADCBEABCD
CEDFE->DAFAAEABFA
BCFFB->CDDEBEABAE
BABEC->FEBCECDCEF
FEFEE->BCFADCDCBA
BCFEA->CDDEBEFAED
CCECB->EFBABABAEC
FACDD->BEBCBFEFAE
CBCAE->AFCDFDFEAB
EECBB->FCFADACDCE
ABADE->DCCDFBEFAB
BEEFE->CDFACBEDAB
CDCED->BFEFDAFAAE
BFEDD->FEABFACBCE
EEBDF->CBDCECEFCA
CEFAD->BFFABEBCFC
FDCDF->BCEFBDCBDC
ABFCB->DBAFCBBAEC
FBEFE->BECDADABBA
FDDBC->EAEFEAAFEB
DFFCB->EFABACBAEC
FCACA->BEDEFBDEBE
BBEBA->DACDADCDDC
FACBE->ABFEAFCDAB
DFCBF->CEABDECDEA
AAEAF->DBFEABFECA
CEADA->DEFACDCBFD
BAEBE->ACFEFACDAD
BFBCA->EDABFEDEDC
FBAFA->CBAFBEABCD
AFFBC->FBABACAFEB
ACCAD->DBDEDABCFA
DBECD->EBCDABBACE
CEFFC->DAFABCABFD
AAACD->FBFEBEBAAE
BFECB->CFEDABBAEC
EEFBD->BFDCABAFEA
BACBD->CFFEDFAFCE
DFAFB->AEABDBEDCF
AAADE->FBFEBECBBF
AADBD->BCFECACDFC
DDBBE->FACBECAFBF
EECDF->BADCFDCBCA
FCFAE->BCDEBEBCDF
EBDBC->BFCDAECDFD
EEAEA->FCFACDFAED
FDCCA->CAEFDEDEFB
FCBDB->CADECDEFCF
DCEAA->FCBABABCFB
AABFC->BEFEECEDFD
CBFED->FDAFBCFACE
CECBD->FEFAFDAFEB
EBCEF->ADCDBFFABE
BFADF->ECEDBCCBDC
CCFAD->FEBADCFEAE
DCFDB->CEBABCEFDA
BFDAA->CFEDFAFEFB
DABDA->EBFEECEFCD
ADAAA->DBEFCDBCDC
ECFFC->BABADCEDFD
DEDED->EBFAAEFAEB
BCCEA->DADEAFDCBE
CFBCB->EFEDFEDECD
FDCFB->EAEFFDEDCF
DDBBA->AEEFEDCDFB
BDCFA->EDEFEBEDDC
FFFFD->ADABACABAE
BFDEB->DEABFCDCAE
CDEBD->FDCBFCAFEA
CFEFD->FDEDABEDAE
CFDBF->EBEDFCAFBE
ECFDA->BABADCEFCD
EDBAA->FCEFCFFEBE
CEFEE->BDFABCFABA
CEDBB->DEFAAECDCF
EDAEC->DFCBCDFAEB
FEAAD->ABDCEDFEAE
CFAAF->FEABEDFEBC
CABFD->AFBCECEDFA
EADAF->ADBCFCFEBE
ECCEE->CDBADEFAFB
CBDCA->FECDBADEDC
ACDEB->FDBAEBFACD
BCEBD->CFBAFBCDBA
CDFFB->DAEFBCABFE
AFFCC->DCABCBBAEB
FEFFE->CBDCEAABBF
FEEFA->BCFABAEDFB
DFACC->FAEDFBDEDF
EBBCA->FCAFCFBABC
CDDDE->BDCBCECBBF
BFBBA->DEABFECDBC
EECEE->FCFADAFAFB
DBABB->EFCDDCCDED
CCEBA->BDBAFBCDFB
FBEFD->EACDFAEDFC
CDDDA->FDCBEFCBFD
FAEED->CAFEBADCAE
DEDDE->AFDCAEEFBF
CDAFA->DAEFBCEDDC
AEDAA->BCDCFCFEFB
FEBBA->BEFAECAFCD
EFBBE->FAEDFECDAB
DCBDC->EBDEECEFDE
FBBDB->ADAFCFCBCD
DBDFD->BCAFAEABAF
AFFDF->CFABCBCBCB
DADFC->AFBCAEABEF
AAABA->BCFEFBCDDC
BFFDE->ACABACEFBA
DBBBC->FACDEDCDAF
CACFD->FEBCAFABEB
BFDDB->CEABAEEFED
CDEBF->DECBBACDBE
DFCDF->BAEDFDCBCA
AEAEA->BEDCBEDCBE
DBCBE->CACDEBCDBF
CFEBA->DAABBFCDBC
FDBBD->CBCBECAFEB
FBEAA->CACDABFECF
CEECE->DFDCBFDEBF
CCBBD->EFBAECAFEB
FEECF->CADCBABADC
DBFBB->EBCDCBAFEC
BDBDA->DECBECEFCD
FDEEC->ABCBBADCFD
EFACB->BAEDFBDEEC
DEFFA->FCDCCBEDFB
DFFFC->AEABADABDE
CCFFD->EFBADCEDFA
ACCAE->BEBADABCBA
DEBAA->AEFAEDBCDC
BCBFC->DADEEDABFD
FAFEA->BCBCEAFACD
DDAEA->EFCBFDFACF
DBDBB->FCAFBACDCF
FAEDF->DEFEBACBCB
ACECD->DBDEBFDEAE
EBCAA->DFAFFDFEDC
DDCDE->AFCBFDCBFC
BEEAA->EDFABABCFB
BEBEF->CFDCDEDCCB
ADFEE->CFCBDCDCBA
DDCCE->FACBFDBAFC
FEEBB->CBDCADCDFE
ACDEC->EDBAEFDCEB
FFEFC->BEABBAEDAF
EFBDC->DFEDFEEFDE
EDBDA->DFCBCDEFBC
EAFAC->DFFEABFEAF
DCABA->AEDEDCCDFB
BFCCD->CFEDFDBAEF
CBFEF->DECDEAFABC
BEBAB->CFDCDEBCFE
EAEBD->BABCBFCDAE
CDBFF->DAEFCFEDCB
CFDCF->BDABEBDEAB
EAFCB->FCFEABDEED
EDACE->FACBFDBABF
DBDED->FACDBADCFA
CBDDE->FDAFEBEFAB
CCDEA->FDBAEFDCED
DDFDB->AFCBCBCBEC
CCBAC->EFBAECFEDA
EDEDC->BACBDFCBDE
CADCC->FDFEAEDEDA
AFAAE->BCEDDCBCAD
DDEFA->FCCBBAEDFB
DADEA->EFBCFCDCED
EBFCD->FACDEADEFA
FCCFD->ADBADAABEB
AFDAD->FBABEBFEFA
DCEBC->AEDEBFCDFD
CCECE->DADEABBABA
EEEAB->DFDCFCFEEC
EADFB->FAFEFAEDED
EACFB->FCFEDFEDED
FBFEA->CBAFADFACD
EBEEA->CBAFABDCDC
DDEAD->EBEFABFEBA
BEEEA->DADCDFDCBD
CCAEA->FEBADBDCBE
CEDEB->EBDCFCDCAE
CDFAD->AFEFCAFEFC
DDFEB->EFCBDCDCEC
BDACE->CDEFBCBAFB
BDBBC->FEEFEDCDAF
EEEFF->BADCADABDC
FBFDE->ABAFABCBBA
EBFEB->DFAFABDCAE
DDCAF->EBEFFDFEBC
CBCED->FECDAFDCFA
AAEEE->BEFEFADCDF
FBFAD->EACDADFEFA
DBDFE->FACDBAEDAB
BCACB->ECBADCDEDA
EADDB->DFFEFACBEC
ABFFD->CFCDEAABEB
BEBDA->EDFAECEFCD
DAFBA->EBFEABAFBC
FEFEC->ABDCCBDCFD
FFEBB->DCEDABAFAC
EACBA->DFFEDFAFBE
AFBDB->DCABFEEFED
EBDDE->BFCDAEEFBF
BDDCF->ECEFEBDEAB
DDADE->CAEFDCEFCB
CBDDC->EFCDBAEFDE
ECEBE->FADEDBCDAB
BCECB->DEBABABAEC
FDBDC->CAEFEDEFEB
DAFBA->EBFEABAFBC
DCADF->AFBADBEFCA
FBCAC->CACDFDFEDA
FBDBF->DEAFAECDCB
EEEDD->BADCADEFAF
CFFAD->FDEDCBFEBA
BEBAB->CFDCDEBCFE
DFFAF->BAEDCBFECA
CCEDF->DADEABCBCB
EEDAE->BFDCFAFEAD
CCAAB->DEDEFBFEEC
CCDFE->FEBACEABBF
CDACE->AFEFCDBABA
AAFDB->DBFEBCEFDA
CAADA->FDFEDCEFDB
EFEEF->BAEDBFDCAB
ADEBD->DBEFBFCDAE
CDABF->BDCBFDAFCB
FAEEB->EABCDFDCDE
DEFBB->CEDCCBAFEC
DFABF->BAEDBCAFBE
FCCFB->ACBAEBEDFE
CBECA->BDAFABBADB
CFACC->EFEDDCDEBD
CBEFA->DACDFAEDDC
DBCDF->AECDFDCBCA
EBBBE->BFCDCFAFAB
DBADE->AFCDFBEFAB
DCEED->FABABADCAE
CDDBA->DECBCEAFBC
BFACC->DEABEDBAFE
BEBCC->ECDCECBADE
CFAAD->BFABDBFEAE
DACBB->FCFEAFCDCF
ECFCD->FCDEBCDECA
AADCA->CDBCAEDEDC
AEDFA->EFFAEBABCD
CEFFC->DAFABCABFD
ACFAA->DBDEBCBCDC
EDFFA->BFEFCAEDBC
BDFED->ACEFBCFACE
ECAFB->BABADBEDCF
DBCCA->EFCDBFDEBC
BEFBA->EDFADCAFCD
CECEC->DFDCDAFADA
DCBEA->CEBACDFAFD
FEEDE->BCFABACBDF
EAEEA->BABCBFDCBE
ECEBB->ADDEDBCDCF
BFADA->CFEDBCCBFD
AFCEE->DBEDFDDCBA
CACDB->FEBCAFEFED
CDDAC->DFCBAEBCFD
DEDEE->BADCFADCAD
DBDCB->CEAFEABACF
FBEFF->CACDABEDBE
ABCBC->BDAFEBCDAF
AFDAF->DBEDFAFEBE
AFEBB->EDEDABAFAC
FDDED->ABCBCEDCFC
FEBEC->EAFACDFABD
EBBFF->BACDEDABCB
EDFEB->FACBDCDCEC
DADAB->EBFEFAFEED
FEFBB->EAFABCCDED
CBBCD->EFCDEDBACE
DBDCA->AFCDBADEDC
BBBFB->CEAFECEDCF
EBDEF->BFCDAEFABE
CDAEB->FECBEDDCEC
AAFCE->FBFEABDEDB
FECCD->ABDCEBDECA
CFEEC->FDEDABDCFD
FFABA->CBEDFBCDDC
DAEDC->AEBCBACBFD
CEACB->EFDCDCDEDA
ABDEE->CFCDCAFABF
ACEAF->CDBABABCBE
CDDDE->BDCBCECBBF
ADEBC->BDCBDFAFFD
ABAEA->CDCDFBFACD
FEBFB->DCDCECEDCF
FEEDE->BCFABACBDF
ADBBE->FBEFCFAFAB
DCAEE->CADEBCDCDF
DCDAC->AEDEAEBCFD
CACDE->FDFEDAEFAB
EDDFD->FCEFEAEDEB
CBDBD->BFCDFCAFBA
CDADE->DAEFBCCBBA
DBCCB->AFCDAFDECD
FBDFB->ADAFEAEDAC
DDBCA->FCCBDADEFB
DFBBB->FCEDFECDCF
DFCAF->EAEDFEBCEA
EFFEB->BFEDABDCAE
EBEFE->FBCDBFEDBA
EDFBC->BFEFCACDFD
FDCAE->CAEFDEBCDF
BAFEA->DEBCEAFACD
FDCCB->ADEFDEDEED
CACAD->AFBCFDFEAE
DFDAA->EBABEBFEBE
BAEAF->ECFEABFECA
FACAC->ADFEDFBCFE
EFEFA->BAEDBFEDBE
CFBBA->BDABDECDFB
BEACD->ECDCBEBAAE
DCCEA->FCBAEBDCED
FACCA->CBFEFEBADB
ECEED->ABBABADCAE
FFFCF->CAEDCBBADC
CBEFF->FDAFBFEDAB
CDFFD->FECBCBEDAE
BCDAA->DEBACEFEBE
BCBDD->FEDECDEFEA
DACDF->EBFEDFCBEA
AABBA->EFBCDACDDC
FACCD->CAFEFDBAEF
DDABE->AFCBEDAFBF
CAACA->DABCBEBABC
ADEED->DCEFCBDCFA
BCFDB->DEBADCEFED
FDCBC->CBCBFDAFDE
FDAFA->ECEFDCABED
ABEDC->BDAFBACBFD
DCEAD->EFDEDBFEFC
DABAB->FCFEEDBCFE
EABAE->FAFEECFEAB
CACFC->DEBCBFABEF
CCAEB->EFBADBDCEC
FEEFF->DEDCBFEDAB
BEACA->EDFAEDBACD
EFCDE->FCABDECBBA
EEFAE->FADCCBFEBF
CBFEF->DECDEAFABC
EFCEF->DBEDEBDCCB
DCBAE->AEDECDBCDF
FFABF->ABEDDCCDBE
ABEEA->BCAFDBFACF
FCEFF->ACBABAEDBE
BEEAA->EDFABABCFB
ADCCE->FBEFFDBAFC
FDBBB->ADEFEDCDED
FBBED->ABAFCFDCEF
CDDBE->FDCBEFCDAD
DEECF->AEFABFDEBC
EDDBC->DFCBEBCDFD
AFCCD->BEABDEDECA
DCEBC->AEDEBFCDFD
CDFFA->FDCBCAEDBC
EACBE->FAFEDFAFBA
BDBCA->DACBDADEFB
FDEFE->CBCBDFEDAD
AFBDE->DBEDCFCBBF
AEBFA->BEDCECEDBC
BEDCE->ACFAAEDEBF
EDEFB->BFEFBFEDEC
EDDDF->ADEFAFCBCB
DCBFC->FCBAECEDFD
DEBEB->AFDCFEFACD
EDABE->CDCBDCCDBF
BCABA->ECBADCCDFB
ABDDA->BCAFBAEFCD
BDFBD->CFCBACAFCE
FBBAC->BECDFEBCFD
AADED->CFBCFCDCFC
AFCCF->DCABFDBACA
FBBFE->ABAFCFEDAB
EEEEB->BFDCBADCFE
EECFA->CBDCEFEDDC
BECAA->CFDCDEBCED
DBABC->AFCDFBCDBF
DEDEF->AFDCAEFABE
BBBEA->DACDFEFACD
CAFFA->FEBCEAABCD
CAAEB->FDFEDCFAEC
AFFDB->FDEDABCBDA
DCDDD->FABACECBEB
CCAAC->ABDEBCFEAF
FECCE->CBDCFDBAFC
DBDBC->AECDAECDFD
DDCDE->AFCBFDCBFC
EBCBF->CBAFFDAFBC
EBCFC->FCAFFDEDFD
CEEBB->FEFADFAFCF
ABBBB->DCCDEDCDED
BEBDF->CDFADACBDC
BCBAE->ECBAEDBCAD
DEEBC->FADCADCDBF
ADBBD->DCEFDACDCA
ABDFC->EDAFEBABDE
CECDA->BDFADAEFBC
AFDFB->DCABFCEDFE
EBBFA->DFAFCFEDBC
DDEFD->EFCBBAEDAE
FEDAA->DCDCFAFEFB
FEBCD->ADFACDDECA
ECFAF->ADDEBEBCCB
EBCAD->FCAFFDFEAE
AEBFA->BEDCECEDBC
DDAEF->EBEFBCDCCB
CFBAD->AFABDEBCAE
CCFAB->DADEABFEED
CDDCD->EFCBFCBACE
FAFAC->EABCCBFEFE
BFDEF->CDABCEDCCB
BACEA->CFFEDFDCFB
FEAAE->CBDCDCBCAD
DEFDC->AFDCEAEFFD
CFAAC->FDEDBCFEAF
FFAEB->ADABCDFAEC
CFFBB->FEABCBAFEC
DEEDA->AEFABFEFCD
BACEF->ECFEDAFABC
DAEAB->EFBCDFFEEC
EBCBC->ADCDBFCDEB
FACDC->EABCBFEFDA
EFAAA->DFEDDCBCDC
AEEBE->DBDCBACDBF
FFEDB->CAEDABCBEC
DDAAC->EFCBFDFEFD
CEDAD->EBDCFCFECA
BEEBD->CEDCADCDCA
BDFDD->CECBEAEFEA
BDBCA->DACBDADEFB
FDBCC->ADEFEDBAEB
CAEBF->EBFEADCDEA
BFCFB->CDABEBEDFE
AAEED->DBFEABDCAE
FCAEF->ABDEFBFABC
BADEC->DEBCAEFADE
CAEEE->DABCBADCAD
CCBDF->BDBACDEFBC
AACED->FBFEDFDCEB
ABFBC->EDAFBCCDAF
EDEBA->BACBDFAFBC
ECBFC->ADDEEDABFD
EFDBF->ADABCEAFAB
FEFDD->EAFABCEFAF
CBECC->FDAFBFDEDA
CFEBE->DFEDBFCDAB
DDDEC->EBEFEADCDA
DBEAC->EFCDADBCBF
CDCEF->FECBFDDCAB
EAABC->DFFEBEAFFD
BFCCF->EDABFDBACA
DCFBA->FCBADCAFCD
BCCEA->DADEAFDCBE
CFFAA->FEABCBFECF
EDFBB->ADEFDCAFED
BFFEF->ACABACFACB
CCBFB->EFBAECEDCF
DECEF->BADCEFDCEA
ACBAE->DBDECDBCDF
BCDEC->FEDEAEFADE
ABDCA->EFCDFCBADB
DBCDD->FACDAFEFEB
EAEFA->CBFEABEDFB
FABDF->CAFECFCBAC
CCBEB->EBDEEDFAEC
AFCCB->CFABFDBADE
FECDC->CADCEFCBFD
BBBED->FECDCFDCEF
ABDDC->FBCDCAEFDA
FAFBA->ECFECBAFBE
BFFBD->CEABEACDFA
FCFFD->EADEABEDFC
BCFAA->ECBABEBCED
FADAC->ABFECABCFD
FCBDE->CBBAECEFBF
ABEFB->EDAFBFEDEC
EEBCD->FCFACDDECA
AADAF->CFBCFCFEBE
CBCAC->FDAFDEBCBF
FCCFA->BCDEAFABCD
BCAED->ECBADCFACE
AECCB->DBDCEFBAEC
EEDEB->ADFAAFDCFE
DADBC->EBFEFACDAF
FDACF->DECBCFDEBE
FFFBC->EAABACAFEB
CCDBF->DEDECACDAB
BDBDE->CDEFCFCBBF
FBFDB->ACAFADEFED
DBCED->BCAFDAFAAE
FEEAF->ABDCDFFEAB
BCCBA->CDDEAFCDBC
ADABF->CDCBFDAFCB
BDDDA->ECEFEBEFBC
AFEFF->BCEDADABDC
AECFB->DCFAEBEDFE
BAFDB->ECFEBCEFDA
CCDFE->FEBACEABBF
EEEBA->CBDCBACDFB
EDCCD->BACBFDBAEF
CAFBD->EFBCEACDFA
CCDCF->DADEFABADC
EACEA->FCFEDFDCFB
DFEDF->CEABBFEFCA
AAEDF->DCBCADEFDC
AEAFD->DCFAEDEDFA
BDEDD->ACEFABCBFC
DFBAD->EFABDEBCAE
FABAC->CAFECFFEDF
FFECA->CAEDABBADB
EBBCD->ABAFACDECA
CBEDA->FECDBFEFCD
EAAFA->DFFEBEABCD
CAADD->FEBCDCEFAF
FCDDD->EADEFACBFC
EACDB->BABCFECBEC
AADCE->BCFECADEAD
CCFFD->EFBADCEDFA
DABCE->AEBCECBABF
ECEBB->ADDEDBCDCF
BECEA->EDFAEBDCED
DBEBE->AFCDBFCDAB
CABBA->FEBCFECDBC
FDFCB->EAEFBCDEED
BDACD->CFCBCDBACE
FFBAA->BEABAEFEBC
EFCDB->DFEDBFEFCD
DEADF->EBFACDCBDC
DFEBF->AEABFACDEA
FCAFB->CBBADBEDCF
FBCFF->BCCDAFABAC
EFBFC->FAEDFEABEF
AEABA->CDFAEDAFCD
FAEBC->ABFEADCDBF
BFBFD->EDABFEABAF
DBAAE->AECDBCFEAD
DCAEF->BADEDCFADC
CDAAA->FDCBCFBCED
EEEDD->BADCADEFAF
AFFBF->BEABACAFAD
DBCEE->FACDAFDCBA
DBBFB->FCAFACABDE
EAABC->DFFEBEAFFD
EFFCE->FBABEADEAB
BCEAB->ECBABFBCEC
BEEFA->DEDCDFEDDC
FBDAA->BECDCABCBE
ACDAA->CDBACEFEBE
BFEFD->ECEDABEDAE
EFCFA->FCABDEABFD
DEDFB->CEDCFCEDFE
FAFCB->ADFEABDEED
ADBAC->DCEFDABCAF
ADDAC->BDCBFCFEAF
CCEFC->DEDEDBEDEB
FAABC->EABCEDAFDE
CEEBD->EBDCDFAFEA
FDBBE->BCEFDACDAD
BDEEA->ECEFBFDCBE
FFDFF->ADABEBABAC
FFFFD->ADABACABAE
DFDAB->EFABEBFEEC
CCEAB->FDBAFCFEEC
EEDBA->FCFAAECDBC
EFCEA->CBEDFDDCBE
DDDFC->AEEFEBABDE
CBAFA->FECDFBABCD
EEACB->DFDCBDBACF
EEACA->BADCDCDEDB
BBCEA->ECAFDEFACD
EBFAA->FCAFABFEFB
ECFFF->BFDEBCABCB
FDFEF->CAEFCADCAB
ADFBA->CDCBDCAFCD
BCAFB->FADEBCEDFE
FFBEE->BEABAEDCBA
AFECA->DBEDABBADB
BFACD->CEABDCDEAF
EBBAD->BFCDCFFEFA
BAFBE->DABCEACDFA
ABDEC->DCCDBADCEF
DEAFF->EADCFBABAC
FDBFA->DCEFEDABED
ABCFB->DBAFDAABDE
FCAFE->CADEDCABDF
EFBDA->CBEDCFCBCD
BBABA->CFAFBCAFCF
BAEEC->DABCADFABD
EABFB->BFBCECEDCF
DFDCE->AFABAEDEBF
EBCAC->BFCDFDFEDA
ACBAB->DCDEDABCFE
BBACB->CFAFBCBACD
EAFDF->ABFECAEFCA
CFAAD->BFABDBFEAE
FDBEE->ADEFEDFABA
AFACA->BCEDDCDEDB
EFCFE->FBABDAABBF
FBCEE->BCCDAFDCBA
CEDDE->FEFAFCCBBA
EECCB->BFDCEFBAEC
CBCDC->ABAFEBCBEB
FFFFE->ABEDEAABBF
ABBAC->BDAFECFEDA
DCECB->CEBAFBDEDA
EAFBA->FCFEABAFBC
EDAFE->FBEFBEABBF
BEFEE->ACFABCFABA
DDAFD->FACBEDEDFA
EDBBF->ADEFDACDEA
BDFCD->ECEFCADEAE
ABCBA->EFCDEBCDFB
BDABC->AECBCFCDBF
FEDDD->ABDCFCCBCE
FAEDB->ACBCBFEFED
CADAB->DABCFAFEED
BEAEA->CFDCBDFADC
DCCEB->AEDEDAFACD
FADCE->ABFECADEAD
DEFCB->AFDCEADEEC
ADCFA->EFEFDAABCD
CEBED->EBDCAEDCFA
BBDBD->CFAFEAAFCE
DDFDF->EBEFBCEFDC
CBDFA->FDAFEBABCD
BFCCF->EDABFDBACA
FBCEC->ABAFFDDCEF
FDEFA->BECBBAEDFB
CFFAE->DAABACBCBF
DBCAC->AECDFDFEDA
CDBCF->BDCBDADEBE
DDFDB->AFCBCBCBEC
DFECF->EAEDFCDEBC
ABDEA->BEAFEADCFB
AFECE->FBABBFDEBF
FCFFD->EADEABEDFC
BAACE->DABCDCDEBA
EEFDB->FADCCBCBEC
DECBE->FADCFDAFBF
FFCBE->CBEDAFCDAB
BFBCC->DAEDFEDEDA
FCEFB->ADBAFBABED
CBAFD->FDAFCDABFC
FEBBE->CBDCFECDAB
DEAFF->EADCFBABAC
EFFFE->FAEDEAABBF
ECDAD->FCDEAEBCFA
ABCEB->FDAFDAFACD
AEBDE->BEDCECEFBF
CDCAC->EFCBFDFEDA
AEFDE->CFDCCBCBDF
AAEDF->DCBCADEFDC
DAAEF->CEFEBEDCAB
DEFAD->EBFABCBCAE
CFAAE->AFABCDBCAD
BFCFD->ACABDEABCE
EAEBA->BFBCBACDFB
DADCF->AFBCAEDEBC
FBCEE->BCCDAFDCBA
AFFFE->BCEDEAABBF
DDEDB->EFCBBACBEC
ADACC->DBEFCDBAEB
CFAAC->FDEDBCFEAF
EBFAE->FBCDBEBCDF
FFCDC->BEABEBCBEB
CDFEF->FDCBCADCAB
EEDFD->BFDCFAEDAE
DDEBB->CECBBFCDCF
DFEBA->EBABBFCDBC
CEDAB->FEFAFCFEED
BCCFC->ECBADEABEB
BECFD->CEDCFDEDFA
BDEBC->DACBBACDAF
BCCFF->EDBAEBEDEA
ABFEB->CDCDBEFAEC
ACFBE->DCDEADAFAB
EDDDC->FACBCECBDE
CBADC->DACDDBEFDE
FECAB->DCDCEFBCFE
AEABC->DBDCBEAFFD
FECDE->ABDCEBCBBA
FCBED->ADBACDFAAF
CFFDC->DEABDCEFDE
EFBDE->BFEDECEFBF
ABCBB->CDCDAFCDCF
BCECE->CFBAFBDEBA
FFBBA->BCABFECDBC
BFECA->ECEDABBADB
AAEFA->BCFEADABFD
BFDFA->CDABCEABCD
FBADB->CACDBCCBDA
FBEAF->ACAFBABCBE
EAFAE->BFBCABFEAD
EDCDC->FCEFFDCBFE
CCEDE->FDBAFCEFAB
CCAAC->ABDEBCFEAF
EBABD->ABAFCFCDCA
BCBCD->EDBAECBAEB
DEBFB->EFDCAEEDEC
FEFDC->CBDCEAEFFD
DFEDF->CEABBFEFCA
FDBCB->CAEFEDBAEC
DCABE->FABADBAFAD
BBADB->ECAFCDCBDA
DDAAF->EACBDCBCEA
ECBAE->BFDECDBCDF
FBFAE->BECDEABCDF
BAAEB->ECFEDCFAEC
BBCEC->FECDFDDCEF
EDBAC->BACBECFEDA
FCCFD->ADBADAABEB
BFEAB->FAEDBABCED
CAEED->FDFEABDCAE
BEAED->ACFACDFACE
DDFCF->BAEFCADEBC
EFECD->BAEDBFDEAE
EDCCA->BFEFDEDEFB
BCFCB->CEBACBBAEC
EBCAF->BACDAFBCAB
BAEFC->DEBCADABEB
FCFCA->BCDEBEDEFB
FCFBE->CBBADCAFBF
BACCC->DABCAFDEDA
ACFDD->DBDEBCEFAF
EDDCB->FACBCEBACD
ACBDC->BEBACDEFFD
DECCD->EFDCEBDECA
CBCFB->FDAFDEABAE
EBBFF->BACDEDABCB
AADEF->BEFEFADCEA
CFCBA->EBEDBFCDBE
DCEFD->BCBADFEDFC
BCEFD->EDBABAEDAE
BBDBD->CFAFEAAFCE
DCDDD->FABACECBEB
FCEBD->ADBAFBCDBA
CAADE->BDFEBECBBF
AAFEA->CDBCEAFACD
BFADD->ACABCDCBCE
FECCB->CADCEFBAEC
AEBDD->DBDCECEFEB
EDEEA->BFEFBFDCBE
EEAFD->BADCDCABFC
DBECD->EBCDABBACE
AAEFE->DBFEABEDBF
DEBDA->AFDCFEEFCD
AAEDC->DBFEABCBFD
AFDCB->DBEDFABAEC
CAFDF->BDFEABCBDC
CACEE->DFBCFEFADF
CBBAB->EFCDEDBCFE
AEDBC->DCFACEAFFD
BADCC->ECFEAEDEDA
FADCA->BCBCAEDEDC
ADDAB->CDCBCEFEEC
AAACD->FBFEBEBAAE
BCFCB->CEBACBBAEC
ACEAE->DCDEBABCBF
CABCF->DABCECBABE
DDACF->AFCBEDBACA
FDACB->ACEFBEBACD
AAAEA->BDBCFBFACD
DDEED->BCEFADFAAF
EACAD->FAFEDFBCEB
AFFEC->BEABACFAFD
ADCBE->CFCBEBCDBF
AFADE->CFABEDCBBF
DCADF->AFBADBEFCA
FCEFB->ADBAFBABED
DEAEA->EBFACDFAED
FBCCF->ADAFFDBACA
FCADE->ABDEFBEFAB
AABFF->CDBCFEABAD
AECDB->CFDCEBCBDA
EBBEE->CDAFCDFACB
CDFDE->FDCBCAEFBF
ECCEE->CDBADEFAFB
EAFFE->FCFEABEDAD
FAAFA->BCBCDCABED
BEAAC->AEDCBEFEDF
CFBAF->BDABDEBCEA
BDEEC->FEEFBFDCEF
CDFAC->DAEFBCBCAF
DDBBF->EACBCFAFAB
BECAE->DADCEBFEAD
DECDE->BADCEFCBDF
AAFDF->CDBCEAEFBC
ACFCB->CFDEBEDEED
BDBCF->ACEFCFBABC
AEEDA->DBDCBACBED
EDDFC->BFEFEBABDE
ACBEB->CFDEEDFAEC
BCDEE->ACDECAFABF
EFCDE->FCABDECBBA
CDCCC->DECBEBDEAF
ACACB->DBDEDCDEDA
AADDB->CDBCAEEFED
CEDBE->DFDCEBCDAB
FDCFA->CBCBFDEDBC
CCCDF->EBDEAFEFCA
DDCCE->FACBFDBAFC
FCDFF->BCDECAEDAB
CDCCD->FECBFDBAEF
FAFCA->CAFECBBADB
FBFCD->ABAFABDECA
EABAC->BFBCECFEDA
CEDFE->DAFAAEABFA
CCBBE->DFBACFAFAB
FDCBF->CAEFDECDEA
BACBD->CFFEDFAFCE
AACBD->BEFEDFAFCE
EBDEF->BFCDAEFABE
CEAAD->AFDCBEFEFA
ADFAC->BECBACBCFE
FCBEB->ACBAECDCEC
ADEAF->DCEFCBFEBC
DCEAF->CEBAFBBCBE
DDDEC->EBEFEADCDA
CDBAD->EFCBECFEAE
FBEBE->CBAFBACDBF
EFEED->FCABBFDCFA
BFADE->DAEDDCEFCB
EEDFF->CBDCFAEDBE
AADCF->DCBCAEDEBC
FFAEB->ADABCDFAEC
DFBFE->FAEDEDABDF
ECCFA->DFBADAABCD
BEFDA->CFDCCAEFCD
CEBFC->ABFAEDABFD
FAFAD->BEBCCBFEBA
ECFEE->BFDEBCFABA
DCCDF->EABAFDCBCA
BDEEF->DACBBADCEA
DBBFF->AFCDEDABCB
DCAAD->FABADBFEAE
ECABD->BABADBAFAE
DFBBF->AFABEDCDBE
EACCC->ADBCBFDEFD
BAACE->DABCDCDEBA
FFADE->BEABFDEFBF
BADDC->DABCAEEFDE
FEBEC->EAFACDFABD
EFAFF->ABEDFBABAC
BFDEF->CDABCEDCCB
BFEBD->ACABBFCDAE
ECAAE->FBDEDBFEAB
CDAEA->DECBFDFACF
BACCB->DEBCAFDECD
FDEAA->BCEFCBFEDC
CACDA->DEBCBFEFDC
BCADD->CFBABCCBCE
DBBBE->AECDCFAFAB
CACAD->AFBCFDFEAE
BAEDB->CEBCBFEFED
FBFFC->EACDADABDE
FDCCD->CBCBFDBAEF
BBBEC->AEAFCDFABD
CEFCE->FDDCABDEDB
EEADF->DBFACFCBDC
ACDDB->EDBAEFCBDA
BCCFA->DEBAEBEDDC
BEFBC->DADCCBAFEB
ECFEE->BFDEBCFABA
BABDF->ECFECDEFBC
EDBFB->BACBECEDCF
FAABC->EABCEDAFDE
BFFCC->EDABCBBAEB
AEADC->FBFACDCBEB
AADAC->EDFEAEBCFD
AEDEE->BCDCFCDCDF
FAEBC->ABFEADCDBF
AAADA->DBFEDCEFDB
AEFCA->BCDCCBBADB
AABAD->BEFEECFEAE
BFBFC->FEABECEDFD
FBFFD->BECDEAABEB
FBCBE->ADAFFDAFBF
AAFCE->FBFEABDEDB
BCDAC->ECBAEBFEDF
FBFBA->CACDCBAFBE
BFBCD->ECEDCFBAAE
BFCCD->CFEDFDBAEF
BECDC->ECDCEFCBFD
EEADA->CBDCBECBCD
CDADB->EFCBEDCBCD
CBDBA->BDAFEAAFBE
FECCD->ABDCEBDECA
AEACF->BCDCEDBACA
FAFEA->BCBCEAFACD
BEBCA->DEDCAEBADC
CFCEC->EFEDBFFADE
DADFF->AEBCFAEDBE
AEDCA->DBDCFABADB
CBCCC->EFCDAFDEDA
EBAEC->BFCDBCDCEB
CAAFA->BDFEBEABCD
DEFBE->CAFABECDAD
DBACE->FACDFBDEAB
DFCBE->AFABDACDFA
EAFDC->FCFEABCBEB
CBAFD->FDAFCDABFC
FFDAD->EAABEBFEFA
FACEC->CBFEFEFAFD
DEAEC->AFDCDCFAEB
FECDF->DEDCDAEFBC
DCABA->AEDEDCCDFB
DADCA->CEFEFABADB
AFDAA->BEABEBFEBE
EBECE->FACDADDEDB
BCACB->ECBADCDEDA
CFEBC->ABEDBACDAF
BFADF->ECEDBCCBDC
FFDEA->CBEDAEFACF
FADBC->ADFEFACDAF
FBCBB->EACDEFCDED
CCBFF->DEDEEDABCB
DDBAE->FCCBDABCAD
EFDEC->ADABCEDCEB
BBEAE->ACAFABFEBF
BAFFB->DEBCEAABDE
EAACF->BFBCBEBABC
FDCDF->BCEFBDCBDC
FDEBE->ADEFBFCDAB
DDCED->EBEFFDDCFA
DCABE->FABADBAFAD
BADEA->CDBCFCDCED
EBFAA->FCAFABFEFB
AFBFE->FBABDEABDF
EBEAA->BFCDABFECF
FCEEF->CADEBFDCAB
BAEED->ECFEABDCAE
FCBCC->ABDEEDBAEB
CBFCC->DACDADBADA
EFFFB->ADABDCEDCF
ADEFE->DCEFCBEDAB
ADBFE->DBEFEDABDF
BAEDE->CDBCDFCBBF
AFBAA->BDABEDBCDC
FEBFA->ECFAEDABED
ABAFC->BDAFBEABDE
CACCB->EFBCAFDECD
EAAFE->FAFEBEABBF
DFEEC->AEABFADCEB
DFEEB->FCEDADFADA
CEDFF->DEFAAEABAD
BFCBB->ECEDFDAFED
CCCCD->EFBAEBDECA
EDBFB->BACBECEDCF
ADFEE->CFCBDCDCBA
BEEAB->DEDCDFFEEC
AEBBF->CDFAECAFBC
ADDAC->BDCBFCFEAF
CAECF->BDFEFADEBE
CEAEC->ABFACFDCEB
FEDFB->EAFAAEABEC
BEDBE->DADCFCAFDB
BAFCB->CFFEABDEED
BECEB->DEDCEBDCAE
DCFEA->EFDEBEFAED
CEDFA->FEFAFCEDDC
FBBBB->CBAFECAFED
FFEEA->BCABDFDCBD
BFECF->DAEDADDEBE
DEBBC->EBFACDCDBF
BBBCF->ECAFEDBADC
BEEFE->CDFACBEDAB
BCDBE->CFBAAECDAB
EFCCD->FCABDEDECA
ACEEF->DBDEBFDCAB
CBCEC->DECDBFFADE
BABBB->DEBCFECDCF
BDEAE->CDEFABFEBF
ACFAB->FDBABEBCAE
DBBED->EFCDFEFAAE
DBEDC->FCAFDBEFDA
DCBFC->FCBAECEDFD
DDCDC->EBEFFDCBFE
CDDAD->FDCBEFBCFC
CBFFE->FDAFBCABDF
BBBAE->CFAFCFFEFA
FCCEF->BCDEAFDCAB
AADEA->BCFECAFACF
FFEFC->BEABBAEDAF
EDCBD->ABCBFDAFEB
AACCD->DBFEDADEFA
BDCDE->EDEFEBCBBA
ACBEC->DBDECDFABD
CFAEC->DEABFDFADE
BBEBC->AEAFADCDBF
AFABA->EFABDCCDFB
CCEDF->DADEABCBCB
EFFFB->ADABDCEDCF
BADFD->ACFEFAEDAE
BBCCC->DECDAFDEDA
FABBD->CAFECFAFEA
CDCEE->AFEFDEFAFB
CBDEC->ABAFCEDCEB
BCEAF->ACDEDBFECB
FCFDE->ADBABCEFCB
FCEFD->CBBABAEDAE
BCDAF->EDBACEFEAB
BABFF->ACFEECEDCB
DBBCC->AFCDEDBAEB
FAEBF->ACBCBFCDCB
CAABF->DABCBEAFAB
ABBAF->BCAFACFEAB
CEBFD->EFDCFEABAF
FFDFA->DCEDFAEDFB
AFBFD->DCABFEABAF
CADDE->DABCFACBDF
EAEFC->DFFEFAEDBF
CBCBD->FDAFDECDCA
EDDDD->BACBFCCBCE
CAFFC->DFBCBEABEB
BFAAE->CDABFDFEBA
FBDFE->BCCDBAEDAB
BBAAF->CFAFBCFEBE
BFCCA->DEABFDBACD
BBBAB->DECDEDBCFE
EBABF->BFCDBCAFBE
EDEBA->BACBDFAFBC
DABAD->EBFEECFEAE
DABCC->FAFEEDBAEB
CBADF->BDAFBCCBDC
EEFFB->BFDCABEDFE
ADBDE->BCCBDACBBA
ABCDF->DBAFDAEFBC
FDBFB->CBCBECEDCF
BEAEA->CFDCBDFADC
DBAED->EBCDBCDCFC
DFDAF->AEABAFBCEA
AFDFC->FBABEBABDE
BDCEC->ECEFDEFADA
FCBBB->DCBACDCDFE
DEBBA->FCDCAEAFDC
BEBAC->FEFACDBCBF
EBFFE->BFCDCBEDBF
FBEBE->CBAFBACDBF
EDFDD->ADEFDCEFEB
CFAED->FEABEDDCFA
DEABC->AEFACFCDBF
FAADF->ACBCFBEFBC
FFCBE->CBEDAFCDAB
DAEBE->FAFEADCDAD
BDCFA->EDEFEBEDDC
CFCFD->EFEDBFABAF
FBCAC->CACDFDFEDA
BFBFF->DAEDFEABAD
FAFBF->CAFECBAFAD
FBADC->ADAFBCCBEB
EDBEA->BACBECDCBE
ECABF->ADDEFBCDEA
ECCDD->BABAEBCBCE
EDEFD->FACBBAEDAE
EEFFB->BFDCABEDFE
ADAAE->FBEFBCFEAD
FBFFD->BECDEAABEB
FDDCB->DCEFEBDEEC
ACBEF->DCDEDADCCB
BAAFC->ECFEDCABFD
DEBCB->FCDCAEBAED
FAABD->BEBCEDAFEB
FFDFB->CBEDAEABEC
ECACE->CDBADCDEBA
AEFDF->DBDCABCBDC
FCFCE->ABDEBEDEDB
CBEFF->FDAFBFEDAB
BBACC->FECDBCBADA
FBAEF->DEAFDCFADC
AFFFD->BEABACABAE
CEABB->EBDCEDAFED
AAAFC->DBFEDCABFD
AAACE->CFBCEDBAFC
FDCAA->DCEFDEBCED
FFDBD->CBEDAECDAE
FBBDB->ADAFCFCBCD
FECCC->ADFADADEDF
CAECE->FEBCADDEDB
BDCFE->CFCBDEABBA
DAFAB->AFBCEABCAE
FCACC->ADBABCBADA
DAAFA->CEFEBEABCD
BCEDE->ECBABFEFBF
FDBFC->EAEFCFEDFD
BFEDD->FEABFACBCE
ABBEC->BEAFCFDCDE
FDFAB->CAEFCAFECF
AEAEB->EDDCBEDCEC
BAACE->DABCDCDEBA
FEFDA->ECFABECBFD
EFEAF->DBEDBABCBE
CAABC->EFBCDCCDAF
DFAEE->FAEDFBFAFB
EDFDC->DFCBACEFEB
CDACC->FDCBCFDEAF
FCAEC->BEDEFBFADA
CBBEC->DACDCEDCFD
CFFDC->DEABDCEFDE
AFAED->DCABEDDCFA
BBCCC->DECDAFDEDA
CEAFF->EBDCEDEDCB
DECBF->EADCDACDAD
DCCBC->FABAEBCDAF
DCBAD->EABACFFEFA
CCAAF->FDBACDBCEA
ACBED->BEBACDFAAF
FAEBA->CAFEBACDFB
CECAC->ABFADEBCBF
DEBAB->EBFACDBCAE
EEFFA->FBFACBEDFB
DADDF->BAFEFACBCB
DEBAE->FADCFEBCBA
BEFAC->ECDCABFEAF
BAEAC->EDBCADBCBF
BBEBA->DACDADCDDC
EAAEB->BFBCBEDCEC
BECEC->DADCEBDCEB
DDFEE->FCCBDCDCBA
BBBCB->CDCDFEDECD
ADCEE->BCCBEBDCDF
FBAEA->BCCDFBFACD
CDBDC->FDCBEDEFEB
EDECC->DFCBBFDEDA
DAEAE->FCFEADBCDF
ACFDA->EFDECBCBED
BFACE->ECEDBCBAFB
EFABD->BFEDBEAFEA
CAEFB->FEBCADABAE
EBFFA->CBAFABEDDC
BECBB->CFDCDECDFE
AECAE->CFDCEBFEAD
BDFCA->EDEFCBBADB
EEDFE->FCFAAEABFA
DEFBD->AEFABECDCA
BBBFB->CEAFECEDCF
EEEBC->DFDCFCAFFD
AEFEC->EDDCABDCEB
EBDAD->FACDCABCFA
AEFBF->BCDCCBAFAD
DBDBA->CEAFEAAFBE
DCFDA->AFBADCEFCD
DAFDF->CEFEABCBDC
CFFEA->EBEDEAFACD
CFCBB->FDEDFDAFED
FFCDD->CAEDFDCBEF
AFFAE->BEABACBCBF
AFCBF->CDABFDAFBC
CBCCB->FECDAFDECD
EECCD->FADCEBDECA
DAAFF->AFBCDCABCB
DDCDF->CECBDECBDC
CDBAC->ABEFCDBCBF
AFDBD->DCABFCAFBA
AFFFA->CDABCBEDFB
FCFAB->ADBABCBCFE
CCFFE->DFBACBEDBF
BFAAB->CEABDCBCFE
CEFEA->FDDCABDCED
AFABF->BCEDDCCDBE
EFBCE->FCABDEBABA
FBBFA->BCCDEDABED
ACDCE->DBDEAEDEBF
BFEDF->ACABBFEFCA
BFECF->DAEDADDEBE
BFEAB->FAEDBABCED
BCEDD->CEBADFCBEB
EADEB->BABCEBFACD
DAACA->EBFEBEBABC
BACCF->CDBCBFDECB
DEAEF->AEFACFDCCB
BCDDF->ECBAEBEFBC
AFEDE->DCABDFCBBF
FFAAC->CAEDBCFEAF
BDEBE->CFCBBFCDAB
EFBAD->FAEDFEBCFA
FECED->CADCEFDCAE
ECBAF->DBDECFFEAB
FBACE->BCCDFBDEAB
BEEBB->FAFABFCDCF
CFFBC->EFEDEACDEF
BCEFF->DADEDBEDAB
DCACF->CEBABCBABC
EBBFF->BACDEDABCB
FCCCE->BEDEAFDEBF
AAEBE->FBFEFACDAD
BFEFF->CDABBAEDBE
CAFCE->BDFEABDEDB
CEEFB->EBDCDFEDFE
CDDAF->DECBCEFEAB
BEFDC->EDFADCEFDE
EBDEF->BFCDAEFABE
BFEED->CFEDABDCAE
FCDAD->ADBAAEBCFA
AABAF->DCBCFEBCAB
DAFFD->AEBCABEDFC
FDFBB->ACEFCBAFEC
CFBDC->EFEDFEEFDE
AEEEC->BEDCBADCFD
FCDAB->ACBACEFEEC
CDFBF->FECBCBAFAD
BDBEC->DACBDADCEB
ECDEE->ABBACEDCDF
AEABF->DCFAEDAFBC
BFEAA->CDABBABCFB
CFCBE->FEABFDAFBF
AAACB->EDFEDCDEDA
CDBBC->DECBDACDBF
DFFFB->FCEDEAABDE
FABAA->BCBCFEBCBE
EFAAA->DFEDDCBCDC
BAEAF->ECFEABFECA
DDDBC->FACBFCAFFE
DDCFA->AFCBFDEDBC
DDAFA->EBEFBCEDDC
CFEBD->EFEDADCDCA
BADDE->CFFEFACBDF
ECCEA->FBDEBDFACD
EBDAD->FACDCABCFA
BCAED->ECBADCFACE
DFFDF->EAEDCAEFCA
BDAAF->DACBFDFECB
ABCAE->BCAFFEBCAD
BACEB->CDBCBFFAED
FFEAA->DCEDABFECF
BBDEA->CFAFEADCFB
ADEBB->CDCBBACDED
EAFFA->BABCBEABFD
AFFFD->BEABACABAE
EBDFF->ADCDCAEDAB
DCABE->FABADBAFAD
ADEBE->BECBBFCDAB
ADADC->BDCBEDCBDE
FBDBE->ABAFEAAFBA
DDAFD->FACBEDEDFA
FEFAB->ACFACBFEAC
BBFBA->ECAFBCCDFB
CFCFE->DFEDAFABBF
ACFBD->BCBABCCDBA
EFCDE->FCABDECBBA
BCEBC->ECBABFCDFD
CEDCC->DEFAAEDEDA
FEDDB->CADCFACBEC
EAFCC->FAFEABDEAF
FCBAF->ADBACDBCCB
FADEE->CAFEFCDCDF
BBFCD->FECDCBBACE
CABDD->EFBCFEEFEB
FDDBB->CBCBFCAFAC
AFCBA->BDABDACDDB
CEFBC->DFDCBECDBF
FFFAE->ADABACBCBF
FBCBF->ABAFFDAFBC
AEEAA->EFFABFBCBE
FFAED->CBEDFBFAAE
ACDBB->CDBACEAFCF
BBEBA->DACDADCDDC
BDBBF->DACBDACDEA
CBDCD->FDAFEBDEFA
ACBCD->DCDEDADECA
DBCCC->FACDAFDEDA
DDFDA->EFCBDCEFCD
BEDAB->FAFAEBFEEC
BEABF->EDFAEDAFBC
FEFEF->ACFACBDCEA
DEFEC->EFDCCBDCFD
DADCF->AFBCAEDEBC
ECAFA->CBDEDCABED
BFADC->EDABEDCBDE
CEAFA->FDDCBEABCD
CFDAD->EFEDFCFECA
FDBED->CAEFEDFACE
BFFAF->CDABDCFEBC
BFEAE->ECEDABFEBF
AAEBC->EDFEABAFFE
AEFCD->CFDCCBBACE
ACADB->CFDEFBEFCF
EEAAD->FADCEDFEAE
ACCFD->BEBADAABEB
BEAAF->ACFACDBCEA
EBFDB->ADCDEAEFCF
FAEAB->DCFEABFEAC
AEBCE->BCDCAEBABF
BBEBF->ACAFABAFBE
DCFEC->FABADCDCEF
EFAAB->ADABFDFECF
BAFAF->CFFEABFEBE
DFCFF->AEABEFEDEA
FCDBC->BEDECACDEB
CDDEC->DAEFEADCDA
EBEFA->FCAFABEDFB
DAABC->FAFEFBCDBF
DBCCE->AECDFDBAFC
CCFAC->DEDEBEBCBF
AECAF->DBDCEFBCEA
CBEAB->DACDFAFEEC
EAFBC->BABCBECDBF
ABFFE->DBAFCBEDBF
EBFDB->ADCDEAEFCF
DEEBA->EFDCDFAFBC
DEACF->BADCBEBABC
BAAFB->CEBCFBABDE
FFBFB->ADABDEABFE
ABDCF->BCAFBADEBC
BFBFB->CFEDCFEDCF
ACCEE->DCDEBDFAFB
BDBCB->ECEFEDBAEC
BBFBA->ECAFBCCDFB
CEEAA->FEFADFFEBE
BAEFD->CEBCBFEDAF
AAABC->FBFEBEAFFD
BEEBB->FAFABFCDCF
BFCEB->FAEDEBDCAE
BFDCA->DAEDFCBADB
FCBDC->ADBACDEFFD
DDCFC->FCCBEBEDBF
BEDDD->FEFAAEEFEB
DDEDD->FACBDFCBEB
FEFAD->ADFABCBCAE
CAEDD->BFBCFACBCE
EEFFD->FADCCBEDAE
DFDBC->EFABEBCDFD
BAFCC->FEBCABDEAF
BAECE->EDBCADDEDB
EDAEA->CBEFCDFAED
FFEED->ADABBFDCFA
ECDEB->FCDEAEFAED
CFDDC->FDEDFACBFD
AADAF->CFBCFCFEBE
FFEDE->CBEDBFEFBF
ACBFC->BDBACFEDFD
BBAAF->CFAFBCFEBE
BDFAC->AECBCAFEFD
CFCAB->DAABDEBCAE
FDFDB->CBCBCBCBEC
FABBC->BEBCAEAFDA
FBFBD->CBAFADAFEA
ACFEF->BEBABCFADC
DCFBB->AEDEBCCDED
CFFDB->DAABACEFEC
ADFFB->FDEFCAEDCF
BBCCD->CEAFEBDECA
DDFED->FACBCBDCAE
AFCAD->DCABFDFEAE
BDABC->AECBCFCDBF
EBDBE->FACDCACDBA
DBEEC->FACDBFDCEF
BCDAD->CFBAAEBCFA
FCEDE->CADEBFEFBF
EDCAC->DFCBDEBCBF
FABED->CBFEACFAAE
BCACC->AEBADCDEBD
EFAEA->BFEDBEDCBE
AAEEF->BCFEADFAEC
EACDD->ADBCBFEFAE
ECCEB->BFDEDAFACD
CFBFE->BDABDEABDF
ECDAC->BFDEAEBCFD
ADABD->BCCBFDAFAE
DCACB->AEDEDCDEDA
EDCBC->BACBFDAFDE
FCEED->EADEABDCAE
CEDDE->FEFAFCCBBA
BFFDC->FEABADEFDE
FFEFF->ABEDADABDC
DEECB->EFDCDFBACD
AECEB->CDFAEBDCAE
EEBCD->FCFACDDECA
FBDFA->CACDAEABDB
DCADA->CEBABCCBFD
BACFE->ACFEDFEDBF
EBEFD->ABAFDBEDAF
FBAFC->BECDDCABFD
CDADF->DECBFDEFCA
FFFBA->DCEDCBAFBE
CDCFC->DFCBDAABDE
AADDA->EFBCAFCBED
DEFED->BCFABEFACE
BCBFA->EDBAECEDBC
FAFEE->ABFEBEFABA
FFCEF->ADABDEFABC
CBDDD->EBCDBAEFEB
EFFEC->FCABACFAFD
FDEDB->DCEFBFEFED
BDEAE->CDEFABFEBF
BFEDD->FEABFACBCE
FBCDB->DCAFDECBDA
ECDDB->FADECAEFCD
BADEE->ECFEAEFABF
AFBDD->CFABFEEFEB
CEACD->FDDCBEBAAE
BEFAD->CFDCCAFEFC
FABDB->DCFECDEFCF
CCDFD->AFDEAEABAF
DEBED->EADCEDFACE
FABAB->ACBCEDBCFE
FFBAE->CBEDEDBCAD
ADAEF->BECBCDFADC
DEAFD->BCFACFABFC
DFFAB->CEABACBCED
ACBDA->BDBACFCBCD
DBCBF->BACDFDAFBC
FCCEC->ADBADAFADA
BFADB->CDABFDEFED
CEDCD->FEFAFCBACE
ECBEE->FADEEDFABA
BEEBD->CEDCADCDCA
CDFBD->BFEFBECDCA
FCEBC->CADEBFCDFD
FAAEB->CAFEBCDCAE
DFAED->BCEDBEDCFA
CBCBA->FECDAFCDBC
AFFCD->FBABACBACE
FDBCB->CAEFEDBAEC
BFCBB->ECEDFDAFED
CABBE->DABCECAFBF
EDBFD->ADEFDAEDFC
CBCBC->DFAFEBCDAF
FECCA->BEFAEBDEFB
BFBBF->EDABFECDCB
DCBBF->AEDECDCDEA
EACBD->FCFEDFAFCE
FDCBF->CAEFDECDEA
AAFDC->BEFEABCBEB
DDABA->FCCBFDAFDC
BCFFD->ACDEBEABCE
CFABA->FEABEDAFCD
BAEFC->DEBCADABEB
EECEA->BADCFDDCBE
CCFDA->FEBADCEFCD
BFDBC->FEABAFCDAF
DFFFA->CEABACABDC
ABECB->CFCDADDEED
DECFB->AFDCFDEDCF
FBFAA->ECAFCBFECF
DDBFB->AFCBECEDCF
EEACE->FCFACDBABA
FEBBA->BEFAECAFCD
FAEEA->CBFEBFDCBE
CEEEA->EBDCDFDCBD
FACBA->BCBCAFCDBC
BEEEF->ACFAFBFACB
CEEDE->BDFAFBEFBA
FFFFC->CAEDCBEDAF
DCCAD->AEDEDABCFA
EDCDE->CDCBDAEFAB
FBDCF->ABAFEABACB
EBFFF->DBCDCBEDBE
CFEFE->DAABBFEDBA
AFDCF->CDABFCBADC
EDAFB->FACBFDEDEC
CEEFE->AFDCBAEDBF
CCAED->FDBACDFACE
EDAFB->FACBFDEDEC
DACED->FAFEAFDCFA
BFBCB->DEABFEDECD
CADFD->EFBCAEABAF
BECBF->DADCEBCDBE
ACBBB->EDBADECDED
CCFBC->DADEABAFFD
DCCBB->AFBAEBCDED
AFAEA->DBEDBCDCED
ABFAC->DCCDBEBCBF
EBDCB->DFAFEABACF
CDCEB->EBCBEBDCAE
BBFDB->CEAFADEFED
ACDCC->FBDEFABAEB
EBAAE->BFCDBCFEAD
FFCFB->DCEDFDEDCF
ECDFD->FADECAEDAF
BFFEB->ECEDCBDCFE
FDEAB->ACEFBABCED
AFCBB->DBEDFDAFED
DBAAA->EFCDDCBCDC
AAFAE->DBFEBCBCAD
ACCCA->BEBADADEBE
BFDFF->CFEDFAEDBE
DACFE->FAFEAFABBF
DDCAD->EACBDABCFA
EEFCA->CBDCABDEFB
CBCDA->DACDEFCBED
ACCCA->BEBADADEBE
EBBBB->BACDEDCDED
EBBEC->FCAFCFDCDE
BDBAF->ECEFEDBCEA
BFDED->ECEDFADCAE
ABBBE->DBAFCDCDAD
EFDAE->FBABAEBCBA
DDFCB->CECBACBAEC
DAFDF->CEFEABCBDC
BACEF->ECFEDAFABC
EAABA->CBFEDCCDFB
DABDC->AFBCFEEFDE
BDECC->DECBDFBADA
FFDCE->CBEDAEDEBF
BBFBC->FECDCBAFEB
FFBAA->BEABAEFEBC
FFBAE->CBEDEDBCAD
EDABD->FACBFDAFAE
DACEF->AEBCFDDCAB
EDBDD->FCEFCFCBEB
DFFFC->AEABADABDE
CAEAC->ABFEBABCFE
FCEDD->BEDEDBEFAE
AEFEA->DBDCABDCED
CBBAE->DACDCEBCBF
DEDDB->AEFAEBEFCF
DFEDE->AFABADEFCB
FEFBD->CADCABAFEA
FABCB->CBFEACDEED
CCBAA->DEDEEDBCDC
DFCFA->EBABDEABFD
AEFEA->DBDCABDCED
CFCDD->FDEDFDCBEF
ACDBB->CDBACEAFCF
FCBDE->CBBAECEFBF
BDEFD->FEEFBFEDAF
AABFC->BEFEECEDFD
CFCBF->BDABDECDEA
AEFEF->CFDCCBDCEA
CEBCB->EBDCAEBAED
FABBC->BEBCAEAFDA
EDEEF->ADEFCBDCAB
EDEEE->ABCBDFDCFC
EEBCB->ADFADADEED
ADABB->DBEFCDCDED
CFDFA->DEABCEABCD
EDBAE->FBEFECFEAB
AEDFD->DBDCFAEDAE
FBCBA->CBAFEBCDFB
CBAAC->EFCDFBFEDF
BBBBD->CEAFECAFEB
DACCF->BAFEDFBACB
AABAF->DCBCFEBCAB
FFFBA->DCEDCBAFBE
BDAFA->CFCBCDABED
FCADA->BCDEFBEFBC
EBCAE->FACDBFBCFA
DEAEF->AEFACFDCCB
DDECF->EBEFABBADC
FDCDE->CBCBFDCBFC
ADDBF->BECBEBCDCB
DDBEE->CAEFCDFACB
FFAAF->DEEDBEFEAB
EEEEB->BFDCBADCFE
CFCBD->AFABDECDCA
CAFCB->DABCABDEED
BFDDB->CEABAEEFED
CCACD->AFDEDCDEAF
EADBC->FCFEFACDAF
EDEBA->BACBDFAFBC
FBDFA->CACDAEABDB
BFFCE->DAEDEADEAB
AAFEB->CFBCCBDCFE
CEDBE->DFDCEBCDAB
EAEEC->ADBCDFDCDE
CCEFD->FEBABAEDAE
FDADE->ADEFCDCBBA
CEBDA->FEFACFCBCD
EBDCA->BACDBADEDC
ABAEA->CDCDFBFACD
CBBFD->BFCDECEDFA
CBCFD->AFCDFDEDFA
EFDEF->CBEDFADCEA
ACBEF->DCDEDADCCB
EDDDA->BFEFEBEFBC
ADADC->BDCBEDCBDE
EDBEA->BACBECDCBE
AEABE->BCDCEDAFBF
EDFED->ABCBCBDCAE
AFCDD->DBEDFDCBEF
CBCFC->DACDEFEDBF
AFABB->CDABEDAFED
ACDCF->BEBAAEDEBC
AFEDA->BDABADEFDB
CBFFC->EFCDBEABEB
CCEEA->DADEABDCDC
DEECB->EFDCDFBACD
FDCFF->ABCBEBEDEA
CDFDE->FDCBCAEFBF
DCDDD->FABACECBEB
CFFCF->FDEDCBBADC
AFECD->DCABDFBAAE
DDCEC->AEEFDEFADA
DFAEB->EBABCDFAEC
DFADC->AFABDCEFBD
EBABE->FBCDFBCDAD
DFADA->EBABCDCBFD
DDCAB->AFCBFDFECD
AFBBB->CFABFECDCF
DEBAA->AEFAEDBCDC
ABFAC->DCCDBEBCBF
FBBDB->ADAFCFCBCD
FFBDE->CAEDCFCBBF
FBCBC->BECDBFCDEB
ABEAE->FBCDADBCDF
BCAEF->CDDEFBFABC
FBCFC->ADAFFDEDFD
FADDD->CAFEFCCBCE
AEAAB->DBDCBEFEEC
BEAEE->DADCEDDCBA
EFEBB->FAEDADCDFE
EDFDF->DBEFBECBDC
AEDFE->BEDCFAEDBF
EEEFE->FADCDFEDAD
EFEAB->BAEDBFBCEC
FDDEF->BCEFAFDCEA
EFDBF->ADABCEAFAB
AAAEA->BDBCFBFACD
EACAB->BFBCFDFECD
ABCAB->CFCDBFBCDA
ADBBB->FDEFEDCDED
ECFCC->BFDEBCDEAF
DEEEA->FCDCDFDCBD
FDDCB->DCEFEBDEEC
CEAEA->DAFACDFAED
EDCEB->ADEFBDFACD
CFCFF->FDEDFDEDCB
CFFFB->EBEDEAABDE
DBAAC->FACDFBFEDF
BBFAD->ACAFABFECA
DBCEB->EBCDFDDCEC
CFECC->DEABBABAEB
CABFD->AFBCECEDFA
DDCCF->EACBDADEAB
FFECF->ACABADDEBE
ECDCD->ADDECADEFC
EEAEE->FBFADCFABA
ECCCB->FADEAFDECD
DEBFB->EFDCAEEDEC
AFDCE->DCABFCBABA
EBBFB->ADCDFEABEC
DEBDF->BADCECEFCA
BCCFF->EDBAEBEDEA
FBDBF->DEAFAECDCB
AECFB->DCFAEBEDFE
DDCCB->EBEFFDBADE
BECFE->ECDCEFEDAD
BFEAA->CDABBABCFB
FDFAC->ADEFCAFEFD
ABEDA->EFCDBACBED
FBFDF->DEAFCBCBCB
DFCBD->EFABDECDCA
BDCCB->CFCBDEDEED
DFEFC->FCEDADABEB
ADABE->DCEFDBAFAD
AECFE->DBDCEFEDAD
DEBFC->AFDCFEABEF
AFEEF->DCABDFDCCA
DCAAC->AFBADBFEDA
BCFFE->DADEBEABBA
DFDCB->AEABAFBAEC
ACAED->DBDEDCFACE
FAEFD->BEBCDFEDFC
CBECD->BFCDBABACE
EFACC->DFEDDCDEBD
ADECA->BCCBBABADB
AAFFD->DBFEBCABFC
DDDFC->AEEFEBABDE
EDFAA->FBEFCBFECF
ECEDA->CBDEBFEFCD
ECCEA->FBDEBDFACD
ABEAC->EDAFBFBCFD
EAFCC->FAFEABDEAF
ACAFA->BCBABCEDDC
DAFDF->CEFEABCBDC
AEFBB->CDFADCAFED
EBAFB->DFAFBCEDFE
BDBBE->ACEFCFAFAB
FABCD->BEBCAEBAEB
CDCBA->DAEFFDAFCD
EBDBC->BFCDAECDFD
FABDC->CBFEACEFFD
EFAFC->FCABCDABFD
CEFFA->EBDCCBEDFB
FDDFE->ABCBCEABBF
BFACD->CEABDCDEAF
FABAE->ABFEEDBCAD
DCABC->EFDEFBCDBF
BEAEA->CFDCBDFADC
BBBDB->CFAFCFCBCD
CCAAC->ABDEBCFEAF
EAFEB->ADBCCBDCFE
DCDEF->EABAFCDCCB
AEAFB->FDFACFABFE
ACEFF->CFDEDBEDAB
BCDFA->DADECAEDBE
BAAEE->EDBCDCFABA
DDEBD->AEEFBFCDAE
CDBBD->FECBECAFEB
EEFFB->BFDCABEDFE
DDCBA->EBEFFDAFCD
EEEDF->ADFACBEFCA
CEBBE->FEFACFAFAB
DDEAD->EBEFABFEBA
AAEAB->EDFEABFEAC
DFCAF->EAEDFEBCEA
BCECD->ECBABFDEAE
DCEEB->EFDEDBFAED
FFECE->BCABDFBAFB
DDBEE->CAEFCDFACB
FEFFB->CADCABEDFE
BCABC->FEDEDCCDAF
BBEFB->CDCDADABAE
DAEED->AEBCBADCAE
DBCCE->AECDFDBAFC
CDABA->EBCBFDAFDC
EDDAA->BACBFCFEFB
CDCDC->DAEFFDCBFE
DCECF->BADEBFDEBC
BECCE->EDFAEBDEDB
BFACC->DEABEDBAFE
AEAEB->EDDCBEDCEC
CEAEF->FDDCBEDCAB
EBABA->FCAFBCAFCF
FCFAB->ADBABCBCFE
CCEFF->EBDEDBEDAB
FDEFD->ABCBBAEDAE
ACAEE->BEBABCDCDF
BBBEF->ACAFCFDCCA
DEBCC->AEFAEDBAEB
ACBFC->BDBACFEDFD
EAFEA->DFFEABDCED
CEFEF->EBDCCBDCEA
BCFEE->ECBABEFABA
FBCDE->BECDBFEFAD
BDACA->DECBEDBACD
ACEFF->CFDEDBEDAB
DBEAF->EAAFBABCBE
AEBBB->DBDCECAFED
BABAC->ECFECDBCBF
CFAFC->DAABCDABFD
BDAFC->EDEFBEABDE
BBDDC->DECDBAEFDE
EBABC->BACDFBCDBF
CDFAF->BDCBDCFEBC
FCECD->CADEBFDEAE
EADAD->BABCEBFEFA
BEBBB->ECDCECAFED
DACFA->AEBCFDEDBC
CFAAF->FEABEDFEBC
ADBAE->CFCBDABCAD
DFBCE->CAEDECBABF
ACCFB->CFDEAFABDE
CCDAF->FEBACEFEAB
CBFAD->EFCDBEBCFC
ACABB->FDBADCCDED
FEFED->CBDCEAFAAE
EDACD->FCEFBCBAAE
FEEFC->CADCBAEDAF
DDCAC->FACBFDFEDA
ADFCF->BCCBDCBABC
AAEDD->BEFEFACBCE
EDDBE->BFEFEBCDAB
FDFBE->ABCBDCAFBF
AABFF->CDBCFEABAD
ACAEE->BEBABCDCDF
FECEB->EAFADAFACD
ADEBD->DBEFBFCDAE
EEFAC->BFDCABFEAF
CDDDF->EBCBCECBAC
BCBAC->DEBAECFEDA
DFBFC->EFABDEABFD
FEEFC->CADCBAEDAF
FAABA->DCFEDCCDFB
EBDCC->ADCDCADEFD
DFBEB->EFABDEDCAE
EDEED->BACBDFDCEF
DFFDF->EAEDCAEFCA
EBCDC->BACDAFEFDE
DEAEB->EFDCEDDCEC
DCAAE->FCBADBFEAB
CECAB->DEFADABCEC
ADCBA->BECBDECDDC
CCBEA->BDBACDFAFD
EFACC->DFEDDCDEBD
CAEBC->DEBCDFAFFD
CBDEA->DACDFADCDC
FCDEE->BCDECAFABF
AFFAB->CDABCBFEAC
FACEF->CAFEFDDCAB
ACCEF->CDBAEBDCCB
AFAEB->FDEDBEDCEC
BECED->ECDCEFDCAE
BFBEE->DAEDFEFAFB
CFFEB->FDEDCBDCFE
DAEFF->EBFEFAEDEA
FFDBB->ADABEBCDCF
FBDAF->BCCDBAFEAB
DCECE->CADEADDEDB
CBBCC->ABAFECBADE
FBEBA->BECDADCDDC
ECDBF->CBDEAECDCB
BBEBF->ACAFABAFBE
ECADB->ADDEFBEFCF
BDCDC->AECBFECBFD
DCBAA->EFDEEDBCDC
DFBCB->CEABDEBAEC
EEAFF->ADFAFDEDAB
BCEDF->CFBAFBEFCB
FFECA->CAEDABBADB
DECEF->BADCEFDCEA
AEFBA->EFFABECDDC
EFEEE->FAEDADFACB
AADBC->BEFEFACDAF
CFBBA->BDABDECDFB
FDECF->ADEFBFDEBC
EEFFC->FCFABCABFD
AFEEF->DCABDFDCCA
DFAFD->EFABCDABFC
DEFEE->FADCEAFAFB
DAEDD->EBFEFACBCE
EAAEE->CDFEBCDCDF
CEAAD->AFDCBEFEFA
DABDD->FAFEEDEFCE
EAFBE->FBBCBECDAD
FCBFD->CADECDABCE
DADBE->AFBCAECDAB
CFABB->EFEDDCCDED
AECBF->CFDCEBCDBE
DABCB->AFBCFEDECD
AECAC->DCFAEBFEAF
BDAFC->EDEFBEABDE
AFBBA->CDABFECDBC
ABEFC->DCCDBFEDEB
DFBBD->EBABDECDBA
FDEFC->ADEFBFEDEB
CCCAC->DFBAFDFEDA
CFAFE->FEABEDEDAB
FACDB->CBFEFECBEC
BFBFA->ECEDCFEDBC
AFFAD->DBEDCBFEBA
CFBEC->ABEDECDCEF
FDFBB->ACEFCBAFEC
BADBA->DABCAECDBC
BBBBA->CDCDFECDBC
BFDAF->ECEDFAFEBE
EFFFA->DFEDEAABCD
DAFFF->BAFEABEDEA
FECFB->CBDCFDEDCF
CBDFB->DACDFAEDED
AECCF->CDFAEBDEBE
FCFFA->ECDEBCABED
FBEEE->CACDABDCAD
EBFCF->ABAFBEDEBE
DAFCB->EBFEABDEED
FABEF->ACBCEDFADC
EBDDC->DFAFEACBDA
ADADB->CDCBFDEFED
AEACD->DBDCBEBAAE
AAAEA->BDBCFBFACD
CDAEE->FDCBCFDCDF
EBDBA->DFAFEAAFBE
AABDB->EDFECDEFCF
ECDFC->FCDEAEABEF
CACBB->EBFEAFCDCF
FDDFB->ACEFCEABDE
DDBDA->CECBCDEFBC
FEECE->BEFABABABA
BDAAC->FEEFCDBCAF
DFAFC->EBABCDABFD
CEABA->BDFACDCDFB
AEBEC->FBFACDFABD
CADCB->EBFECADECF
CEEBC->EFDCADCDBF
AAACC->DCBCDCDEBD
AFFFD->BEABACABAE
DDEFF->CECBBFEDAB
DACFE->FAFEAFABBF
EBAFA->BACDFBABCD
FDCFE->ADEFDEABBA
EDBCF->ABCBECBABE
ABDCB->CDCDBADECD
FCBFD->CADECDABCE
CBAAF->DACDDBFEBC
DDCAB->AFCBFDFECD
BCCAD->ECBADEBCFC
FDEDE->BECBBACBDF
DEDBD->FADCAECDAE
EBFFD->ADCDEAABEB
AAFCA->DBFEBCDEFB
FEFAC->CADCABFEAF
BEBCE->CDFADADEDB
BECBE->ACFADACDFA
ACAAE->CFDEFBFEFA
DFBFC->EFABDEABFD
CEEBB->FEFADFAFCF
EFCBA->FBABDACDDB
CEAAE->FEFADCBCAD
EFFAD->BFEDABFECA
DBDED->FACDBADCFA
CDCEA->BDCBEBDCED
FBBDF->ACAFECEFCA
FCFBF->BCDEBECDEA
EFAAF->BAEDFBFEAB
BFFBF->CFEDCBAFAD
FFFBB->CBEDBECDFE
EECFE->BFDCEFEDAD
FBDFC->ABAFEAEDFE
FAEEA->CBFEBFDCBE
EACBA->DFFEDFAFBE
AFFBD->CFABCBAFCE
AADAD->DCBCAEBCFA
CBCCA->DECDBFDEBC
BAECD->FEBCBABACE
BABAC->ECFECDBCBF
DDCEE->BAEFDEFAFB
BDAFF->ECEFCDABCB
CFFBD->EBEDEACDFA
CAAAD->FDFEDCBCAE
EBCBF->CBAFFDAFBC
BDDDD->EDEFCECBEB
CFDCD->AFABEBDEFA
DFDBA->AEABAFCDFB
BEADD->CEDCDCEFAF
DCFAE->FABADCFEAB
CBABD->EFCDFBCDCA
AAADB->FDFEBCCBDA
CECEE->DAFADAFAFB
FDCAE->CAEFDEBCDF
FEDAA->DCDCFAFEFB
BBDDF->CFAFEACBEA
ECCAB->DFBADABCEC
FFCAF->ACABDABCAB
FDDFD->ADEFEBABEB
FCCCC->CBBAEBDEAF
EFCBC->FCABDECDBF
ADBBD->DCEFDACDCA
FADEA->DCFEAEFACF
ECDBA->BABACEAFBC
CEEBE->FDDCBACDBF
DACDD->EAFEFECBFC
EDACA->DFCBCDBADB
BEBFA->CFDCDEABED
DEBDD->AEFAEDEFCE
FEDBB->DCDCFACDED
FBBCE->BECDFEDEBF
AFCAF->CFABFDFEBC
DEBEC->FADCFEFADA
DDBFF->EBEFCFEDCB
AFACA->BCEDDCDEDB
BFBAE->EDABFEBCBA
AADEB->DCBCAEFAED
DADDA->AFBCAEEFCD
CDBCE->FECBECBABF
BDCFE->CFCBDEABBA
FECAB->DCDCEFBCFE
























































































































































































































































